"site","year","daynum.tenth","daynum.median","daynum.nintieth","daynum.mean","daynum.range"
1,1976,83,93,117,101.696426857272,34
1,1977,117,120,147,129.223907991489,30
1,1978,108,123,137,129.702673323246,29
1,1979,101,116,132,119.67976743884,31
1,1980,94,113,143,123.289216963689,49
1,1981,104,113,134,121.150953000065,30
1,1982,96,117,128,115.089877026504,32
1,1983,99,116,128,116.266281030971,29
1,1984,96,114,131,118.491891892515,35
1,1985,112,123,143,125.849710986998,31
1,1986,100,115,127,119.043933331552,27
1,1987,99,122,141,125.398390881331,42
1,1988,102,118,138,122.867792075295,36
1,1989,91,112,124,110.436036959325,33
1,1990,93,108,123,110.166882548283,30
1,1991,101,120,141,125.187517080561,40
1,1992,85,107,128,111.366413447466,43
1,1993,85,99,132,109.381009614994,47
1,1994,85,102,120,106.83155058001,35
1,1995,96,111,120,112.275124744973,24
1,1996,101,113,128,119.73255813535,27
1,1997,98,108,127,113.197395923643,29
1,1998,101,114,128,118.828237657396,27
1,1999,86,111,121,110.069559831725,35
1,2000,80,103,129,107.795745196692,49
1,2001,93,114,132,116.188520713601,39
1,2002,78,104,120,105.156909600345,42
1,2003,80,101,124,106.755376342184,44
1,2004,88,113,125,112.437648807021,37
1,2005,95,125,137,121.90144849014,42
1,2006,95,109,126,112.384153141528,31
1,2007,82,109,130,111.694507713946,48
1,2008,105,126,136,124.761749776332,31
1,2009,85,109,138,111.023323607163,53
1,2011,84,110,124,109.841289092876,40
1,2013,102,118,137,122.928324625437,35
1,2014,82,110,124,109.264047579724,42
1,2015,90,102,123,110.18198569138,33
2,1976,86,112,128,111.392627786497,42
2,1977,109,120,137,125.360407566802,28
2,1978,98,108,125,111.920312650913,27
2,1979,94,115,128,115.33934762546,34
2,1980,86,113,135,116.246639517784,49
2,1981,94,116,134,115.632809558836,40
2,1982,88,109,124,108.633495414378,36
2,1983,96,102,123,108.587155964945,27
2,1984,86,107,128,110.417850698597,42
2,1985,101,114,143,122.126253801342,42
2,1986,92,115,135,115.588824662124,43
2,1987,102,133,158,132.692357239339,56
2,1988,95,111,125,113.131181157088,30
2,1989,82,115,124,112.598020797811,42
2,1990,81,103,114,101.321817799004,33
2,1991,101,116,135,118.486705336791,34
2,1992,84,105,128,106.789958241527,44
2,1993,86,110,128,111.843131392725,42
2,1994,92,102,113,103.191358912833,21
2,1996,93,109,121,112.144674242879,28
2,1997,88,112,130,112.638623785972,42
2,1998,85,99,129,109.128503732051,44
2,1999,86,100,121,105.552234097936,35
2,2000,88,108,123,110.380510962834,35
2,2001,93,115,132,118.373854570442,39
2,2002,95,116,128,116.705933126637,33
2,2003,95,106,127,113.004195260704,32
2,2004,104,123,139,124.474640312875,35
2,2005,95,116,131,117.367543114233,36
2,2006,90,103,126,108.532215645585,36
2,2007,90,106,132,113.354674488126,42
2,2008,92,120,136,120.910248858849,44
2,2009,85,101,124,106.071938536156,39
2,2011,91,110,130,111.984674414744,39
2,2013,99,125,151,128.01010839245,52
2,2014,74,97,124,103.054504413399,50
2,2015,95,109,123,113.063086487547,28
3,1976,83,95,117,101.564582740064,34
3,1977,115,122,138,129.75319261237,23
3,1978,116,131,150,135.199763142225,34
3,1979,101,123,141,124.71477660251,40
3,1980,107,121,142,127.032657310186,35
3,1982,130,160,168,155.079561370341,38
3,1984,99,107,113,109.831665805586,14
3,1985,109,123,137,124.214701889742,28
3,1986,93,116,138,119.25005300468,45
3,1987,97,109,132,116.862321564124,35
3,1988,97,117,144,122.842538495149,47
3,1989,84,110,140,112.729807080882,56
3,1990,92,108,123,113.503856679205,31
3,1991,102,116,139,122.760106400442,37
3,1992,91,111,126,110.450811992323,35
3,1993,97,115,135,120.972212096402,38
3,1994,92,106,127,111.441898361435,35
3,1995,96,111,126,115.547173038724,30
3,1996,98,119,137,120.422738057151,39
3,1997,95,112,133,114.285074437183,38
3,1998,102,113,136,118.671762351377,34
3,1999,96,109,127,114.997429362947,31
3,2000,92,126,142,123.583798311705,50
3,2001,95,113,128,114.498705291681,33
3,2002,87,105,133,110.570700432755,46
3,2003,85,102,124,104.691291270235,39
3,2004,88,118,129,115.09947326574,41
3,2005,89,101,133,109.127620581454,44
3,2006,89,103,126,110.168572296114,37
3,2007,88,106,130,112.609773550747,42
3,2008,90,102,133,109.881248890692,43
3,2009,83,105,122,106.3775788392,39
3,2011,81,102,131,107.854889746034,50
3,2013,102,121,135,124.263223594189,33
3,2014,78,99,121,104.755916018467,43
3,2015,86,107,128,113.615672921085,42
4,1976,86,98,118,102.105776449046,32
4,1977,109,123,138,124.431220022083,29
4,1978,107,119,133,120.176767676577,26
4,1979,102,115,128,116.754534587068,26
4,1980,94,120,137,120.8028735631,43
4,1981,97,111,127,112.837632879984,30
4,1982,91,106,124,107.468926555521,33
4,1983,99,111,128,113.881796689236,29
4,1984,95,114,131,114.602175597779,36
4,1985,101,114,130,116.808264311365,29
4,1986,94,107,127,111.814634138344,33
4,1987,94,106,127,111.748576850297,33
4,1988,96,117,137,120.766421314383,41
4,1989,91,101,124,107.35834559019,33
4,1990,80,103,130,105.881153856363,50
4,1991,96,113,143,120.689579854071,47
4,1992,87,108,128,110.151220245568,41
4,1993,97,106,139,114.348291125907,42
4,1994,92,111,127,111.084944548453,35
4,1995,95,111,122,110.798254356863,27
4,1996,93,113,137,117.485037709595,44
4,1997,85,107,127,111.759358286318,42
4,1998,92,113,134,115.828025410708,42
4,1999,86,100,127,107.83662562201,41
4,2000,80,108,133,110.580919465929,53
4,2001,86,107,132,112.834275024571,46
4,2002,85,108,135,112.163198975012,50
4,2003,87,113,127,112.664406779035,40
4,2004,90,118,139,117.600629546316,49
4,2005,89,117,137,116.794797396058,48
4,2006,89,108,138,114.177860984275,49
4,2007,89,107,129,112.632972267113,40
4,2008,85,114,136,114.600873003485,51
4,2009,85,109,127,111.093714890168,42
4,2011,84,110,136,111.270440281233,52
4,2013,99,118,137,120.643160149183,38
4,2014,74,103,131,106.245416314817,57
4,2015,90,109,120,109.448246746214,30
5,1976,86,106,126,107.2933073634,40
6,1976,85,107,120,106.098133531112,35
6,1977,102,125,158,130.872320230104,56
6,1978,98,123,139,124.033452710708,41
6,1979,95,117,132,117.648219275849,37
6,1980,90,112,135,114.337805915038,45
6,1981,101,116,146,124.245649922524,45
6,1982,96,114,120,114.256292953318,24
6,1983,103,113,130,118.646664102633,27
6,1984,86,110,130,113.071762197912,44
6,1985,99,123,151,127.728746148076,52
6,1986,99,113,146,118.687499971768,47
6,1987,93,114,134,118.358998299096,41
6,1988,98,124,146,124.940408189325,48
6,1989,78,93,118,99.9938102948667,40
6,1990,90,98,123,105.085289995797,33
6,1991,96,117,147,122.455773175342,51
6,1992,83,105,120,105.453041596118,37
6,1993,93,109,130,116.711330521872,37
6,1994,91,102,119,105.027601938642,28
6,1995,89,103,123,109.156900734806,34
6,1996,99,115,130,118.450725599439,31
6,1997,95,113,136,119.785167898046,41
6,1998,94,115,141,121.225026082131,47
6,1999,100,121,142,123.612139466477,42
6,2000,95,116,152,121.52493349537,57
6,2001,93,122,149,125.600016627454,56
6,2002,102,128,155,132.294934271939,53
6,2003,95,109,129,114.607249853595,34
6,2004,86,104,120,107.925049389216,34
6,2005,88,109,140,115.534254971576,52
6,2006,90,108,136,113.472205296666,46
6,2007,97,109,151,118.38392002393,54
6,2008,92,115,136,118.507441886168,44
6,2009,80,121,165,125.837333571507,85
6,2013,87,135,172,133.070340166959,85
6,2014,85,106,141,112.056086956298,56
6,2015,92,113,128,114.185346453085,36
7,1976,81,93,116,101.259707183193,35
7,1977,94,107,134,115.596127681542,40
7,1978,95,105,120,108.950520719252,25
7,1979,92,112,133,115.079566035583,41
7,1980,96,115,138,117.659670320131,42
7,1981,88,113,130,112.992491680072,42
7,1982,78,111,123,109.915056917432,45
7,1983,96,103,123,109.569665964662,27
7,1984,79,95,115,99.7008799552522,36
7,1985,93,101,151,114.591518414431,58
8,1976,82,101,137,110.914540527827,55
8,1977,106,135,156,138.458777329564,50
8,1978,100,130,156,132.377702409325,56
8,1979,103,127,158,132.104839258886,55
8,1980,111,146,166,142.092065616638,55
8,1981,110,138,158,138.444094967426,48
8,1982,91,130,153,128.152556010478,62
8,1983,101,122,145,126.706380942197,44
8,1984,99,127,155,130.355399634621,56
8,1985,112,148,168,147.036662625392,56
8,1986,112,144,162,142.350220353374,50
8,1987,119,142,168,146.239239587912,49
8,1988,102,137,162,139.896274472133,60
8,1989,85,124,142,124.216296660046,57
8,1990,108,135,158,138.160685540684,50
8,1991,119,136,158,141.011560851593,39
8,1992,111,128,151,133.42903811833,40
8,1993,109,144,158,140.73771404792,49
8,1994,103,130,155,133.577606392551,52
8,1995,110,131,141,129.616296766849,31
8,1996,116,136,158,137.985612586075,42
8,1997,110,130,161,134.922113052606,51
8,1998,124,140,158,144.725021152696,34
8,1999,115,135,155,137.007792198401,40
8,2000,113,141,156,142.281127104503,43
8,2001,117,143,165,142.840934458295,48
8,2002,117,143,164,144.521386007758,47
8,2003,115,138,157,137.127975941783,42
8,2004,120,136,157,139.088032616092,37
8,2005,106,138,162,137.037307378956,56
8,2006,109,139,170,140.934199500173,61
8,2007,119,147,164,148.315226905068,45
8,2008,111,137,166,141.714755951905,55
8,2009,94,141,164,139.045232323584,70
8,2011,102,139,162,137.982893916544,60
8,2013,106,142,165,141.26935731506,59
8,2014,85,123,156,125.99422970695,71
8,2015,94,137,160,134.375879003214,66
9,1976,85,118,137,115.381673181892,52
9,1977,102,126,151,130.752851706762,49
9,1978,95,116,149,122.036324945476,54
9,1979,101,126,142,126.707569994875,41
9,1980,102,132,152,132.426051237154,50
9,1981,111,130,157,135.672230951018,46
9,1982,99,130,151,128.675724113165,52
9,1983,99,120,145,124.976477281451,46
9,1984,104,130,149,128.088655599398,45
9,1985,111,128,149,131.806776458285,38
9,1986,100,132,155,133.235827641598,55
9,1987,100,137,153,134.407154776208,53
9,1988,109,137,159,138.608386373204,50
9,1989,93,120,141,125.08924565087,48
9,1990,106,128,148,130.685228600605,42
9,1991,117,135,156,139.008529999277,39
9,1992,107,131,151,133.056068711046,44
9,1993,99,132,148,131.580383402426,49
9,1994,101,128,152,129.085623903475,51
9,1995,100,121,144,126.901815729832,44
9,1996,110,129,148,131.295307352469,38
9,1997,111,131,148,132.17621272927,37
9,1998,115,134,152,136.233606153395,37
9,1999,102,128,153,130.420104780704,51
9,2000,108,127,149,132.824011651059,41
9,2001,107,136,157,136.497043898357,50
9,2002,113,139,156,142.470461816652,43
9,2003,106,132,152,133.382741821697,46
9,2004,104,128,143,130.00555184737,39
9,2005,102,131,155,133.12548886331,53
9,2006,102,127,159,132.616892267857,57
9,2007,104,146,165,141.410040949054,61
9,2008,112,137,158,137.577503128336,46
9,2009,95,140,157,135.752873722896,62
9,2011,102,132,155,134.641592175743,53
9,2013,106,132,156,134.719863739606,50
9,2014,86,121,145,121.669023062182,59
9,2015,91,122,154,123.296828902914,63
10,1976,92,117,137,118.194369095899,45
10,1977,111,130,150,132.826426522497,39
10,1978,108,137,165,139.991262892194,57
10,1979,111,130,157,136.44873072234,46
10,1980,117,137,148,137.796500610544,31
10,1981,106,132,148,135.019316074996,42
10,1982,102,132,151,132.003011774172,49
10,1983,105,117,139,121.977715982647,34
10,1984,92,113,137,119.604193826019,45
10,1985,100,137,148,133.475198236523,48
10,1986,100,136,167,138.485008908511,67
10,1987,112,138,161,139.699737262141,49
10,1988,97,138,151,133.276941375769,54
10,1989,83,116,140,116.221384328786,57
10,1990,95,117,137,119.013994039378,42
10,1991,107,136,158,138.823436217149,51
10,1992,91,121,151,122.604191267613,60
10,1993,88,137,179,138.225028562011,91
10,1994,106,130,151,132.917472312581,45
10,1995,94,116,154,124.275684579875,60
10,1996,105,126,153,132.219966193031,48
10,1997,110,131,152,132.798184976661,42
10,1998,110,131,158,136.284655892343,48
10,1999,106,122,150,129.215477208517,44
10,2000,105,122,152,128.880252727148,47
10,2001,93,122,160,127.735534617425,67
10,2002,109,136,156,138.362265540859,47
10,2003,102,130,149,130.353372119368,47
10,2004,104,131,148,131.260597657279,44
10,2005,110,130,152,133.806261411655,42
10,2006,96,116,147,122.047253897312,51
10,2007,109,137,166,138.642387116204,57
10,2008,107,130,158,135.649085769824,51
10,2009,103,133,158,132.792909306833,55
10,2011,103,130,158,134.150405500649,55
10,2014,86,119,144,121.688658141372,58
10,2015,84,116,133,114.693739850896,49
11,1976,102,114,123,114.221406743341,21
11,1977,95,124,150,125.757079503677,55
11,1978,116,116,120,119.869847691864,4
12,1976,79,86,107,92.5531638925443,28
12,1977,88,107,131,111.584948178052,43
12,1978,94,110,123,113.894742273802,29
12,1979,97,105,123,111.851063392646,26
12,1980,87,112,120,109.057968088336,33
12,1981,94,111,125,112.168275999076,31
12,1983,79,104,121,106.435736556288,42
12,1984,73,107,147,113.704983543442,74
12,1985,88,99,123,107.102073526428,35
12,1986,92,108,123,109.714752119748,31
12,1987,96,124,136,119.96527697863,40
12,1988,91,100,125,105.630555255831,34
12,1989,81,94,109,95.8406593422801,28
12,1990,76,87,106,93.61896130039,30
12,1991,101,108,124,113.446737504489,23
12,1992,82,98,121,105.373909236177,39
12,1993,81,92,116,101.53347050246,35
12,1994,87,94,124,105.800010569504,37
12,1995,88,95,113,101.201647303425,25
12,1996,86,101,113,103.937229171096,27
12,1997,47,90,129,90.869060210489,82
12,1998,96,123,127,118.143688447323,31
12,1999,87,95,109,100.154991504187,22
12,2000,78,112,146,112.691540575646,68
12,2001,87,100,109,100.277468434445,22
12,2002,77,95,123,100.57361332553,46
12,2003,83,97,122,100.621369435426,39
12,2004,83,110,138,114.225890746559,55
12,2005,94,108,130,115.257070564665,36
12,2006,72,112,144,113.108180226479,72
12,2007,60,99,144,104.29180319929,84
12,2008,84,118,144,117.288416190712,60
12,2011,51,81,106,84.5354546516335,55
12,2013,75,110,149,115.958521284608,74
12,2014,88,109,135,113.958157674264,47
13,1976,85,99,120,105.580263043928,35
13,1977,82,119,149,116.439419903974,67
13,1978,88,119,145,121.094629091106,57
13,1979,93,126,151,125.622054208242,58
13,1980,90,114,154,122.120581886142,64
13,1981,126,132,139,134.750368303947,13
13,1982,102,118,132,123.570299108812,30
13,1983,102,112,131,119.51251795364,29
13,1984,102,114,138,121.932378546271,36
13,1985,123,151,172,152.551795059277,49
13,1986,110,131,152,133.085991835071,42
13,1987,97,126,151,128.22399464425,54
13,1988,116,123,128,126.484237892969,12
13,1993,109,119,123,122.865767144555,14
13,1994,88,116,151,120.569542512503,63
13,1995,98,116,127,118.765603400419,29
13,1996,96,123,150,128.514073878358,54
13,1997,79,123,161,123.478182837668,82
14,1977,94,106,132,115.502320418827,38
14,1978,88,108,130,110.896465869615,42
14,1979,94,108,127,116.380117775849,33
14,1980,91,112,133,111.859728494519,42
14,1981,93,106,132,115.489393998336,39
14,1982,84,99,125,103.617438304199,41
14,1983,89,102,121,109.524978047846,32
14,1984,94,107,128,112.422222219376,34
14,1985,93,116,137,119.510951950384,44
14,1986,96,107,120,110.725872809713,24
14,1987,92,117,127,119.115714728089,35
14,1988,80,100,129,107.026391894406,49
14,1989,78,93,123,99.108597814589,45
14,1990,77,106,120,104.965796504153,43
14,1991,111,125,135,128.122022821006,24
14,1992,81,108,132,109.692225687175,51
14,1993,74,102,130,104.927774521938,56
14,1994,92,118,130,116.341057530792,38
14,1995,74,99,131,104.591737547052,57
14,1996,101,125,138,123.618187963885,37
14,1997,88,116,130,113.790764691965,42
14,1998,96,116,132,117.796060318134,36
14,1999,95,108,130,113.745022233239,35
14,2000,93,116,128,114.634441236152,35
14,2001,53,95,137,96.7196844721854,84
14,2003,95,113,130,114.179790167479,35
14,2004,85,106,127,110.467743302126,42
14,2005,88,102,127,110.496632404767,39
14,2006,90,103,115,104.229064407415,25
14,2007,74,105,133,106.481947605911,59
14,2008,81,118,146,118.181335154109,65
14,2009,87,102,133,106.787595807396,46
14,2011,53,102,154,105.505792287476,101
14,2013,65,108,150,111.026643828699,85
14,2014,88,112,130,113.838640214034,42
14,2015,58,102,152,106.632700977815,94
15,1976,53,81,102,81.3034037750993,49
15,1977,108,123,137,127.189464442255,29
15,1978,95,113,135,116.818135416039,40
15,1979,92,106,137,112.458833951783,45
15,1980,83,102,131,109.512959869328,48
15,1981,103,116,131,118.356926798183,28
15,1982,81,102,116,104.896506191807,35
15,1983,92,102,122,106.899417573224,30
15,1984,82,98,121,104.909445697348,39
15,1985,94,102,123,106.955238262631,29
15,1986,91,113,131,115.414043641979,40
15,1987,88,110,128,110.546937541347,40
15,1988,81,109,130,110.237045593056,49
15,1989,82,91,109,95.8660167021523,27
15,1990,83,94,109,97.5564835250647,26
15,1991,101,112,136,119.314929819943,35
15,1992,86,102,122,105.840013214343,36
15,1993,88,102,121,108.175336371933,33
15,1994,89,103,120,107.647423570695,31
15,1995,90,100,125,106.784169363118,35
15,1996,95,111,130,114.188309755306,35
15,1997,95,116,128,116.608443548952,33
15,1998,89,102,124,108.129342811873,35
15,1999,95,108,120,110.821637337114,25
15,2000,86,100,123,103.509950264085,37
15,2001,96,111,132,113.931311197397,36
15,2002,80,104,119,104.696135890949,39
15,2003,82,100,118,103.608856603118,36
15,2004,75,97,125,101.126106290858,50
15,2005,83,109,124,108.07485810194,41
15,2006,81,94,109,97.6261687140424,28
15,2007,81,98,115,101.869683227506,34
15,2008,74,94,115,100.026085242367,41
15,2009,84,95,106,100.982082353008,22
15,2011,75,102,121,102.913427948094,46
15,2013,96,108,123,112.372232723238,27
15,2014,75,99,130,104.781383659625,55
15,2015,79,102,123,106.625703184502,44
16,1976,85,101,120,105.76024485311,35
16,1977,106,133,150,133.368908723607,44
16,1978,89,123,152,124.441280165806,63
16,1979,108,132,149,133.11557695136,41
16,1980,102,138,155,137.660252966985,53
16,1981,118,136,149,139.314973801493,31
16,1982,99,123,150,127.324465347084,51
16,1983,110,123,148,128.370226859744,38
16,1984,94,122,151,125.064455456099,57
16,1985,109,130,163,136.437645488223,54
16,1986,109,144,164,143.261109550394,55
16,1987,97,121,157,126.036106673428,60
16,1989,80,108,130,110.749277255528,50
16,1990,88,115,137,117.637185745861,49
16,1992,90,115,136,119.364976114176,46
16,1993,86,123,142,120.374808480181,56
16,1994,92,113,143,120.315310512776,51
16,1995,85,114,136,115.73549883839,51
16,1996,104,121,149,124.079243142561,45
16,1997,111,131,141,131.051109217015,30
16,1998,96,127,151,129.948979592574,55
16,1999,93,123,142,122.730403115989,49
16,2000,103,128,156,129.295163784655,53
16,2001,93,114,136,119.092490617162,43
16,2002,101,127,150,128.240535161388,49
16,2003,96,113,134,118.304761920164,38
16,2004,96,121,143,124.447999979475,47
16,2005,97,120,142,122.384078190454,45
16,2006,95,114,143,118.622320540299,48
16,2007,102,129,159,133.527777786991,57
16,2008,105,130,151,130.645516081302,46
16,2009,88,122,141,122.35075884418,53
16,2011,93,127,150,127.795283018867,57
16,2013,100,123,142,125.821720790796,42
16,2014,85,113,137,114.801723603776,52
16,2015,85,121,151,122.482193715426,66
17,1976,81,99,115,101.695129066446,34
17,1977,93,114,142,119.336975940639,49
17,1978,88,109,133,111.725398139201,45
17,1979,85,105,133,113.917823131394,48
17,1980,76,104,132,107.299526464926,56
17,1981,96,109,133,114.743801735368,37
17,1982,81,102,123,107.393797106286,42
17,1983,87,107,121,110.148950712987,34
17,1984,84,105,127,109.330472691066,43
17,1985,98,111,144,119.427288827247,46
17,1986,88,111,139,118.50983932672,51
17,1987,89,109,130,111.943317694171,41
17,2011,81,115,144,113.959217888341,63
17,2013,95,112,137,117.291650945909,42
17,2014,85,109,137,114.125778563255,52
17,2015,85,116,141,116.481710811971,56
18,1976,76,86,97,90.2462569542634,21
18,1977,110,124,135,125.62569449672,25
18,1978,98,123,127,117.96724492623,29
18,1979,97,115,133,120.180408589273,36
18,1980,66,112,149,111.370208376974,83
18,1981,97,111,134,116.530700640307,37
18,1982,77,94,114,98.962275278544,37
18,1983,98,107,122,111.414467684283,24
18,1984,92,113,120,113.798640715849,28
18,1985,103,125,143,125.561630032541,40
19,1976,74,101,122,101.942018277504,48
19,1977,102,114,145,121.978440828729,43
19,1978,98,115,135,116.28558397035,37
19,1979,101,122,134,123.210156383455,33
19,1980,88,113,143,116.107063614563,55
19,1981,101,121,147,123.238079436535,46
19,1982,89,109,139,112.646341255107,50
19,1983,100,117,129,117.864965774899,29
19,1984,95,110,123,113.068340211645,28
19,1985,101,122,151,129.712200071313,50
19,1986,104,120,127,119.93481247047,23
19,1987,94,109,131,113.491141503996,37
19,1988,91,106,117,107.365853658535,26
19,1989,73,87,108,94.6014084055296,35
19,1990,84,109,139,110.846169080916,55
19,1991,95,113,134,118.507852755055,39
19,1992,88,105,137,112.917068864132,49
19,1993,95,109,128,113.476297326971,33
19,1994,88,102,128,110.236573646378,40
19,1995,98,103,133,112.633331009155,35
19,1996,98,108,130,115.43423617231,32
19,1997,84,102,126,107.691797245845,42
19,1998,89,109,129,115.05660346194,40
19,1999,87,114,134,113.605154740225,47
19,2000,92,116,133,118.829357100061,41
19,2001,72,100,132,107.117208832704,60
19,2002,79,113,153,116.836528384084,74
19,2003,95,114,137,121.597278592991,42
19,2004,80,114,154,117.214174428263,74
19,2005,89,102,131,111.586280528607,42
19,2006,77,111,137,112.133120640095,60
19,2007,80,129,171,131.197638947568,91
19,2008,85,103,115,105.786664816518,30
19,2009,67,111,140,109.12676431929,73
19,2011,67,95,124,97.3994274595254,57
19,2013,92,120,141,122.105904822559,49
19,2014,92,106,113,107.307679891889,21
19,2015,80,101,122,104.757575675891,42
20,1976,70,85,102,88.298633762271,32
20,1977,74,96,123,102.866322978436,49
20,1978,108,108,115,114.999999999976,7
20,1979,72,108,143,110.705988795616,71
20,1980,90,113,132,115.282931867543,42
20,1981,103,124,145,126.17014064139,42
20,1983,74,110,137,111.218559412476,63
20,1984,96,114,128,116.581927457432,32
20,1985,95,114,130,118.979249422179,35
20,2014,81,106,123,109.102772146577,42
21,1976,82,87,108,95.4138385468902,26
21,1977,102,121,137,122.362044385183,35
21,1978,95,112,133,113.442873702419,38
21,1979,88,107,132,108.82379410105,44
21,1980,90,113,130,112.830060580469,40
21,1981,91,99,127,107.970265758451,36
21,1982,77,104,128,106.22393213632,51
21,1983,96,106,127,112.624920926779,31
21,1984,92,100,136,111.151403589628,44
21,1985,98,109,127,113.651150355715,29
21,1986,89,108,135,112.684381075144,46
21,1987,92,108,136,114.625603127931,44
21,1988,86,107,127,110.012922340835,41
21,1989,78,94,120,99.9878624326279,42
21,1990,78,99,123,104.184967448461,45
21,1991,96,108,134,115.707131189932,38
21,1992,81,100,128,107.08513510147,47
21,1993,84,97,113,100.026987067461,29
21,1994,84,96,118,103.040160107413,34
21,1995,81,95,122,103.431260111038,41
21,1996,86,109,127,111.519456040424,41
21,1997,88,111,130,111.925011421291,42
21,1998,88,111,132,112.086043759713,44
21,1999,77,95,128,103.254468196567,51
21,2000,80,95,124,105.543150803385,44
21,2001,83,111,136,113.477914209086,53
21,2002,78,106,137,112.037686613988,59
21,2003,78,101,125,102.906160603197,47
21,2004,81,104,129,108.220650515641,48
21,2005,87,101,128,107.163604222768,41
21,2006,90,108,120,107.756487931797,30
21,2007,80,101,129,106.036027891948,49
21,2013,96,129,165,132.553433171319,69
21,2014,79,102,114,105.357659398269,35
21,2015,39,95,151,99.5846117079911,112
22,1976,86,103,114,105.869005840425,28
22,1977,102,119,134,119.894611232227,32
22,1978,88,115,139,117.073160057686,51
22,1979,102,130,158,131.262336076264,56
22,1980,99,119,137,119.399168031247,38
22,1981,98,122,150,127.16529147143,52
22,1983,103,116,131,116.695651931179,28
22,1984,88,108,130,111.746600483389,42
23,1976,83,105,118,105.921880234041,35
23,1977,95,119,144,122.772638844102,49
23,1978,80,105,113,102.879224859321,33
23,1979,95,103,117,110.057106780581,22
23,1980,55,120,172,119.481731053919,117
23,1981,98,118,151,125.41347251681,53
23,1982,72,95,114,97.5519626478091,42
23,1983,81,102,125,107.114865206111,44
23,1984,77,104,130,108.406279445336,53
23,1985,87,122,158,122.461548000817,71
23,1986,106,119,142,125.897361600983,36
23,1988,88,115,137,115.887897052105,49
23,1989,77,95,123,101.231034849387,46
23,1990,73,94,124,99.8674250396163,51
23,1991,89,119,134,119.343969552058,45
23,1992,79,105,129,106.780534113201,50
23,1993,78,92,121,103.120762954761,43
23,1994,90,102,131,110.827171297279,41
23,1995,76,98,115,99.1365734349869,39
23,1996,86,106,129,112.312913423184,43
23,1997,77,99,120,104.3887830013,43
23,1998,80,104,132,108.855415681204,52
23,1999,81,108,127,109.685782134278,46
23,2000,87,109,133,111.654229613383,46
23,2001,89,103,132,109.7602118953,43
23,2002,95,117,142,119.771107010425,47
23,2003,85,109,128,111.520547705872,43
23,2004,72,102,132,105.184159869338,60
23,2005,88,117,137,115.534192430268,49
23,2006,91,104,131,111.435360088375,40
23,2007,81,109,138,113.112112465606,57
23,2008,87,114,137,117.17803941328,50
23,2009,83,99,138,107.51543544007,55
24,1976,80,99,136,105.870889327862,56
24,1977,93,107,134,112.821189571616,41
24,1978,95,120,148,125.197574436188,53
24,1979,95,117,137,119.622900778938,42
24,1980,93,116,143,120.215516141013,50
24,1981,95,117,147,119.998730765227,52
24,1982,96,110,123,113.432925904634,27
24,1983,104,115,136,121.560830943308,32
24,1984,92,110,145,117.961549874775,53
24,1985,102,114,130,118.191196913033,28
24,1986,100,117,138,120.155661887595,38
24,1987,95,112,132,116.54690965205,37
24,1988,91,103,124,108.860988863989,33
24,1989,90,110,130,112.276932655696,40
24,1990,97,109,130,114.825687965956,33
24,1991,97,112,134,116.773339890443,37
24,1992,85,101,122,105.55452745143,37
24,1993,86,100,124,105.034973151739,38
24,1994,99,110,127,114.832331389488,28
24,1995,91,94,116,102.893388255425,25
24,1996,107,124,134,122.838304001469,27
24,1997,96,114,136,118.934357552004,40
24,1998,96,116,139,116.983150544888,43
24,1999,93,109,122,111.710673891962,29
24,2000,87,106,139,114.606814598274,52
24,2001,86,100,132,109.878413085827,46
24,2002,95,118,137,118.960419168301,42
24,2003,85,106,131,110.802609925096,46
24,2004,88,118,135,116.852734279459,47
24,2005,87,111,123,111.127263607102,36
24,2006,85,102,117,108.478624824097,32
24,2007,79,102,131,106.579605503962,52
24,2008,91,115,137,117.27033225774,46
24,2009,85,99,121,106.855794796266,36
24,2011,93,111,130,115.549453084482,37
24,2013,85,117,157,122.692700722458,72
24,2014,88,100,126,107.322905868973,38
24,2015,91,106,128,110.169234226763,37
25,1976,85,119,147,120.246649172933,62
25,1977,94,116,145,123.614400740211,51
25,1978,102,123,152,129.13223593635,50
25,1979,117,128,142,132.159782143425,25
25,1980,84,123,148,125.637295646535,64
25,1981,99,133,152,131.884620358753,53
25,1982,65,119,168,122.842432086035,103
25,1983,92,116,137,118.493603292969,45
25,1984,97,114,139,120.932296080253,42
25,1985,93,114,137,119.334024039453,44
25,1986,95,107,127,113.18179334505,32
25,1987,100,118,140,121.632140137407,40
25,1988,91,103,130,112.130022903576,39
25,1989,84,94,124,104.590691267989,40
25,1990,94,110,129,113.030210770781,35
25,1991,106,121,142,124.870125352763,36
25,1992,84,105,130,110.150380734204,46
25,1993,90,110,128,114.416999457184,38
25,1994,89,110,137,115.279963756071,48
25,1995,96,115,129,117.640720648908,33
25,1996,99,113,137,120.053947988539,38
25,1997,98,112,126,116.546692118942,28
25,1998,90,105,139,113.102325618854,49
25,1999,91,107,139,113.924686174464,48
25,2000,95,118,137,120.470111407972,42
25,2001,102,117,135,122.819188195427,33
25,2002,102,124,135,122.643835623308,33
25,2003,86,113,142,119.047428694654,56
25,2004,92,120,142,122.983436138603,50
25,2005,97,117,138,119.380911496378,41
25,2006,89,109,138,114.467608677647,49
25,2007,89,115,135,115.73912402542,46
25,2008,99,122,141,125.271537489674,42
25,2009,87,113,135,117.180744473793,48
25,2011,88,116,141,116.95255779826,53
25,2013,95,113,134,117.07628354211,39
25,2014,78,102,127,107.063069736134,49
25,2015,92,107,128,111.622425947862,36
26,1976,88,102,116,104.68771886089,28
26,1977,94,116,136,118.443593046001,42
26,1978,88,123,156,124.946235246013,68
26,1979,99,117,134,117.04462969721,35
26,1980,90,118,139,118.789810818875,49
26,1981,96,110,124,114.761310219111,28
26,1982,88,109,130,111.957625908724,42
26,1983,101,109,129,116.36493974345,28
26,1984,92,109,127,114.045692720944,35
26,1985,98,116,144,122.776928530056,46
26,1986,97,115,139,119.304204698214,42
26,1987,96,114,137,120.588186816376,41
26,1988,80,106,137,112.709696184588,57
26,1989,79,102,123,104.185277098246,44
26,1990,78,96,117,104.084422294647,39
26,1995,89,103,121,107.70398488774,32
26,1996,95,125,151,126.435115037708,56
26,1997,93,112,127,114.895867408677,34
26,1998,88,107,124,110.845264815408,36
26,1999,87,107,122,107.931727988623,35
26,2000,88,106,120,108.059330317045,32
26,2002,79,102,120,107.53092825693,41
26,2003,81,95,121,102.101286910313,40
26,2015,81,102,123,105.900546426588,42
27,1976,82,105,116,104.746787905906,34
27,1977,109,123,137,129.480178596331,28
27,1978,103,118,144,122.627859140149,41
27,1979,87,108,130,112.372912860609,43
27,1980,91,114,138,120.044168134065,47
27,1981,93,111,132,116.511133310956,39
27,1982,91,108,137,115.91923186585,46
27,1983,99,117,137,120.850412168202,38
27,1984,103,125,144,125.281383940087,41
27,1985,107,123,144,128.601976898119,37
27,1986,102,123,146,125.544882452922,44
27,1987,100,125,144,128.459742794075,44
27,1988,95,118,138,119.832582672734,43
27,1989,94,108,136,116.21631097099,42
27,1990,95,109,124,112.205325156694,29
27,1991,111,120,137,124.511480814022,26
27,1992,98,113,140,119.261041534894,42
27,1993,85,119,135,116.8204611093,50
27,1994,92,116,137,119.569628023792,45
27,1995,96,116,134,115.9672741892,38
27,1996,103,120,137,123.617677603396,34
27,1997,100,126,136,123.985551087158,36
27,1998,95,116,137,120.837837814509,42
27,1999,94,115,136,118.010800027429,42
27,2000,103,121,135,124.654054056901,32
27,2001,93,111,137,115.423438726149,44
27,2002,95,115,130,116.705574900511,35
27,2003,88,109,129,112.777327940439,41
27,2004,93,121,139,122.300856822433,46
27,2005,88,110,137,115.939890701376,49
27,2006,91,102,128,108.449339208896,37
27,2007,88,107,127,112.69999999812,39
27,2008,92,115,137,119.45454545536,45
27,2009,85,114,130,113.775295256592,45
27,2011,80,116,137,114.023599751221,57
27,2014,91,108,129,111.107481930288,38
28,1976,61,96,118,95.9694864306761,57
28,1977,111,124,139,130.392223222998,28
28,1978,111,131,151,134.333231983297,40
28,1979,94,119,138,121.102040778665,44
28,1980,97,116,147,123.410256415763,50
28,1981,104,116,137,120.773684318787,33
28,1982,98,119,131,119.011940297402,33
28,1983,96,117,127,114.859861589288,31
28,1984,104,125,143,127.796698146251,39
28,1985,104,118,139,123.020408163052,35
28,1986,92,113,135,118.320298306079,43
28,1987,101,116,143,121.909814966505,42
28,1988,98,119,140,124.02941181954,42
28,1989,87,110,132,113.897319287107,45
28,1990,95,110,139,116.134328356758,44
28,1991,110,121,142,126.37608913773,32
28,1992,97,111,131,118.160284467138,34
28,1993,87,110,135,115.957965424887,48
28,1994,91,112,131,113.144230428389,40
28,1995,96,112,131,115.392935981796,35
28,1996,111,127,154,135.023174252272,43
28,1997,105,118,130,118.169950866061,25
28,1998,89,106,137,114.732992207037,48
28,1999,72,104,114,100.971443121944,42
28,2000,88,111,133,112.669187421405,45
28,2003,90,110,138,113.566320872564,48
28,2004,88,109,129,111.511527942197,41
28,2005,87,102,126,109.618749893007,39
28,2008,91,102,116,106.168750092605,25
28,2009,88,108,128,110.902124814444,40
28,2011,81,102,140,111.020253898805,59
28,2013,95,113,139,118.107597355884,44
28,2014,84,104,124,104.654034431945,40
29,1976,84,94,122,101.085779329444,38
29,1977,107,124,151,129.773423451454,44
29,1978,98,120,148,124.784980897216,50
29,1979,101,123,143,125.25608349068,42
29,1980,102,130,156,131.26960620028,54
29,1981,101,130,151,131.178519219882,50
29,1982,90,117,143,118.641625354042,53
29,1983,92,109,139,119.007402394665,47
29,1984,96,123,143,124.999169466691,47
29,1985,101,137,163,138.635371902597,62
29,1986,101,130,157,132.343442325531,56
29,1987,101,140,162,137.668666436574,61
29,1988,96,130,148,128.680928540893,52
29,1989,73,96,129,103.189281086029,56
29,1990,95,122,144,122.681424805903,49
29,1991,108,129,148,131.640362808456,40
29,1992,101,128,153,128.367088870942,52
29,1993,102,130,150,130.000464721173,48
29,1994,101,124,143,125.549555264071,42
29,1995,96,122,151,126.756511663352,55
29,1996,106,122,143,127.378183544627,37
29,1997,106,129,151,131.681294775862,45
29,1998,107,132,149,134.258571396263,42
29,1999,103,120,149,126.856501084367,46
29,2000,97,123,151,125.798347080048,54
29,2001,95,121,144,125.740454471851,49
29,2002,100,129,156,132.650466646086,56
29,2003,75,109,155,117.448852051856,80
29,2004,107,133,144,133.070766708905,37
29,2005,102,123,145,127.196233235181,43
29,2006,97,116,152,123.904500210361,55
29,2007,102,139,164,140.436542973127,62
29,2008,84,123,158,127.098195858234,74
29,2009,78,102,140,110.617358429126,62
29,2011,85,125,158,127.77760260229,73
29,2013,99,123,150,127.146104362002,51
29,2015,87,133,154,126.58938681052,67
30,1976,81,101,123,103.995663796483,42
30,1977,100,121,142,124.166073745845,42
30,1978,98,120,148,122.505979635674,50
30,1979,99,120,149,123.932291149239,50
30,1980,103,125,148,127.442642777447,45
30,1981,100,121,151,123.974950604543,51
30,1982,91,115,147,116.023421437986,56
30,1983,95,116,145,121.663617861995,50
30,1984,102,123,150,128.893132062271,48
30,1985,101,130,165,136.367884164437,64
30,1986,101,136,162,139.576989275884,61
30,1987,93,140,162,135.524662200015,69
30,1988,85,123,148,122.331413497995,63
30,1989,80,108,139,112.546353693396,59
30,1990,95,122,144,122.916701895211,49
30,1991,108,130,155,133.683665301662,47
30,1992,101,121,143,127.850929036569,42
30,1993,85,123,151,124.386572510308,66
30,1994,102,123,151,130.178375037026,49
30,1995,96,124,143,126.691262400689,47
30,1996,107,123,141,126.931498371564,34
30,1997,93,123,154,126.773561010213,61
30,1998,114,133,144,135.242283182098,30
30,1999,103,120,145,129.129589966961,42
30,2000,97,132,157,130.556422561845,60
30,2001,95,136,172,134.729610942596,77
30,2002,109,136,157,136.753282987596,48
30,2003,89,101,123,107.105523565856,34
30,2004,110,128,145,132.309525957921,35
30,2005,109,130,152,134.274997495816,43
30,2006,98,126,154,126.142762403681,56
30,2007,103,123,135,125.543813676488,32
30,2008,106,137,155,137.795901030673,49
30,2009,81,119,158,118.912765501918,77
30,2011,85,124,158,128.164345204395,73
30,2013,101,130,156,130.366850643115,55
30,2014,86,121,150,124.021025362721,64
30,2015,92,129,163,131.7860480381,71
31,1976,74,98,119,101.547102311112,45
31,1977,103,111,131,117.389498108978,28
31,1978,98,109,123,112.078108487772,25
31,1979,101,108,122,112.951587688486,21
31,1980,94,109,130,113.082668206491,36
31,1981,88,105,118,105.486801107173,30
31,1982,81,98,111,101.936138185587,30
31,1983,100,115,120,116.470203561553,20
31,1984,87,99,120,106.313120449941,33
31,1985,104,116,132,118.149150454651,28
31,1986,92,106,120,110.367824659133,28
31,1987,98,106,132,111.140855280766,34
31,1988,91,103,125,108.896485858918,34
31,1989,81,96,116,99.6804733191564,35
31,1990,83,97,108,99.5853380115557,25
31,1991,101,116,135,120.122049730702,34
31,1992,84,102,120,103.82945811705,36
31,1993,83,105,125,105.655991382534,42
31,1994,89,102,125,107.741991467386,36
31,1995,87,103,124,110.702872268748,37
31,1996,96,107,127,112.579150510432,31
31,1997,84,100,114,102.971307878046,30
31,1998,97,111,130,113.53210813106,33
31,1999,86,103,117,105.441864087989,31
31,2002,76,97,118,101.242898237644,42
31,2003,82,96,119,100.855807854817,37
31,2004,74,94,118,98.0948095639366,44
31,2005,88,102,124,107.0344914878,36
31,2006,86,94,109,96.9108302790891,23
31,2007,78,96,118,98.0174502471891,40
31,2008,85,99,113,104.813006087738,28
31,2009,80,101,122,105.714680182475,42
31,2011,69,90,115,95.7107414427835,46
31,2013,75,109,151,113.101589320994,76
31,2014,61,94,131,98.2190186337325,70
32,1976,82,96,124,101.968421093512,42
32,1977,102,116,138,119.618423787845,36
32,1978,95,115,137,118.188697554678,42
32,1979,102,116,137,120.766024714125,35
32,1980,88,120,147,121.398643601235,59
32,1981,99,125,147,129.043021730707,48
32,1982,88,104,124,108.531055347808,36
32,1983,92,110,125,111.137965494422,33
32,1984,98,115,137,119.103910746538,39
32,1985,99,116,143,122.844990070279,44
32,1986,99,112,130,116.943279478857,31
32,1987,94,106,140,115.484367996881,46
32,1988,91,109,140,118.438800765058,49
32,1989,81,108,124,106.945945928164,43
32,1990,88,102,130,108.869041911059,42
32,1991,108,127,149,130.269685878067,41
32,1992,97,114,141,117.580961724818,44
32,1993,86,112,141,116.216907814917,55
32,1994,95,109,130,115.668824934199,35
32,1995,97,114,134,117.386245715842,37
32,1996,101,114,138,121.992945511822,37
32,1997,98,124,141,121.769226603615,43
32,1998,101,122,141,125.781954976884,40
32,1999,93,119,142,121.158754337279,49
32,2000,94,116,153,123.618399340447,59
32,2001,93,119,151,125.162624082588,58
32,2002,101,123,151,126.708672248124,50
32,2003,87,110,142,116.484165672729,55
32,2004,97,109,124,112.704610012241,27
32,2005,88,116,152,122.578650952139,64
32,2006,90,108,147,115.900191025147,57
32,2007,88,102,121,106.940492800911,33
32,2008,88,116,144,117.77331899952,56
32,2014,85,116,149,118.497874190189,64
32,2015,85,107,151,119.600466060382,66
33,1977,88,102,116,106.892866653633,28
33,1978,95,116,132,118.415345661922,37
34,1976,87,102,116,103.074542867536,29
34,1977,102,124,144,126.327283896457,42
34,1978,106,120,141,124.023538362975,35
34,1979,105,119,134,120.239142950009,29
34,1980,97,117,138,121.95219823449,41
34,1981,109,133,137,131.142799403303,28
34,1982,88,107,129,111.410770327779,41
34,1983,100,115,129,119.490155506009,29
34,1984,97,116,138,119.081773690443,41
34,1985,104,122,136,124.311337798747,32
34,1986,97,118,137,119.666461340664,40
34,1987,103,115,138,122.61777754344,35
34,1988,100,123,134,122.617902602139,34
34,1989,95,113,127,114.235268849806,32
34,1990,91,112,126,112.03827466211,35
34,1991,105,125,140,126.541146700058,35
34,1992,88,108,128,111.601425845889,40
34,1993,93,118,136,116.552072179443,43
34,1994,93,107,130,115.008183973559,37
34,1995,99,113,127,118.974206102207,28
34,1996,102,118,137,123.069543870133,35
34,1997,85,118,131,115.200763138658,46
34,1998,96,116,137,118.598817110583,41
34,1999,94,115,133,117.541409339326,39
34,2000,93,120,127,119.876935964898,34
34,2001,94,117,130,116.197951601167,36
34,2002,95,117,129,115.343511450886,34
34,2003,90,110,125,111.743356132396,35
34,2004,95,115,138,118.601226080978,43
34,2005,88,107,131,114.197600993957,43
34,2006,89,107,128,110.974988251738,39
34,2007,88,106,133,111.755306313042,45
34,2008,92,115,130,118.928357098349,38
34,2009,89,105,122,110.781676719514,33
34,2011,87,110,127,112.55437101293,40
34,2013,106,128,141,128.053781256961,35
34,2014,86,110,128,111.249984860896,42
34,2015,92,107,127,112.282131657274,35
35,1976,83,98,124,103.72938929455,41
35,1977,118,130,142,131.663542112835,24
36,1976,25,77,137,82.4117468361141,112
36,1977,69,105,132,106.735589472689,63
36,1979,80,117,143,117.120167755737,63
36,1980,121,129,129,128.999999999845,8
36,1981,74,102,139,108.738097386622,65
36,1982,124,124,132,131.999999999761,8
36,1983,99,116,137,121.008601071775,38
36,1984,53,103,151,107.703238043743,98
36,1985,81,116,157,120.603914949546,76
36,1986,102,123,138,122.839250048615,36
36,1987,95,109,132,116.065530388244,37
36,1988,98,102,117,109.599863672212,19
36,1989,87,117,135,117.198106457543,48
36,1990,82,104,125,109.718455288733,43
36,1991,94,116,135,119.707151064236,41
36,1992,84,98,122,103.095708264259,38
36,1993,82,104,124,104.57369939362,42
36,1994,98,113,130,117.405363181335,32
36,1995,98,111,124,113.007823371261,26
36,1996,86,116,141,117.939713051445,55
36,1997,88,112,128,115.833769850542,40
36,1998,74,99,120,102.522084925951,46
36,1999,79,105,138,109.604370482798,59
36,2000,83,95,123,105.28829380329,40
36,2001,96,116,137,119.426095624421,41
36,2002,88,117,151,120.877409059315,63
36,2003,82,98,114,102.244155449584,32
36,2004,83,102,126,106.671927888922,43
36,2005,91,104,119,105.953679295667,28
36,2006,89,103,116,104.902851234896,27
36,2007,73,102,132,106.772602996534,59
36,2008,95,106,130,113.207708119667,35
36,2009,84,104,125,105.49877495408,41
36,2011,75,102,123,102.117861844098,48
36,2013,96,106,130,112.221771732575,34
36,2014,81,93,108,97.6862438307603,27
36,2015,102,109,116,115.554286626855,14
37,2002,148,148,155,154.999999999873,7
37,2003,107,125,146,129.99991505484,39
37,2004,104,128,156,131.823399360262,52
37,2005,93,114,139,119.579210537453,46
37,2006,90,116,137,116.191554047414,47
37,2007,81,115,157,120.583333123238,76
37,2008,100,122,151,128.863783022648,51
37,2009,90,106,135,114.616586905573,45
37,2011,115,125,127,126.000038032319,12
37,2013,109,123,144,129.003494629314,35
37,2014,79,109,145,114.069639430276,66
37,2015,104,134,152,132.733061300298,48
38,1976,81,97,113,100.150425681165,32
39,1977,102,119,133,118.483540595955,31
39,1978,102,118,131,120.401873657938,29
39,1979,95,102,123,110.7581279058,28
39,1980,94,113,132,117.558004846358,38
39,1981,90,102,125,107.042084069053,35
39,1982,96,100,124,108.474276965582,28
39,1983,92,109,121,112.631911483202,29
39,1984,95,109,128,114.461279666352,33
39,1985,94,114,144,122.737673387108,50
39,1986,94,109,130,111.575997161187,36
39,1987,90,100,132,111.702645668491,42
39,1988,94,110,132,115.715302157536,38
39,1989,84,94,126,101.12473498201,42
39,1990,87,110,122,109.629405026212,35
39,1991,93,116,135,120.246642763259,42
39,1992,87,107,128,110.876437805693,41
39,1993,89,107,133,113.05617976038,44
39,1994,88,99,121,107.145168335013,33
39,1995,91,110,130,113.911956929899,39
39,1996,99,117,127,116.802219369056,28
39,1997,93,108,128,113.614460188056,35
39,1998,86,106,126,109.23012994065,40
39,1999,85,104,121,108.040298101885,36
39,2000,96,108,133,114.465335974666,37
39,2001,94,114,136,119.273826074721,42
39,2002,86,116,135,117.66845469379,49
39,2003,86,107,135,113.656129334282,49
39,2004,97,117,137,120.522313925696,40
39,2005,94,107,139,114.966282195968,45
39,2006,86,107,131,112.460254658868,45
39,2007,96,115,146,120.486297215272,50
39,2008,92,113,136,119.268812880109,44
39,2009,91,102,130,111.255241841392,39
39,2011,93,116,143,119.887272666704,50
39,2013,74,116,158,118.299021957807,84
39,2014,84,109,126,110.053633397138,42
40,1977,95,106,123,112.096604279521,28
41,1977,110,127,139,126.793094810124,29
41,1978,95,95,103,102.218716741732,8
41,1979,116,126,151,133.671460442396,35
41,1980,88,122,158,125.284044978818,70
41,1981,100,119,137,120.89123087127,37
41,1982,104,119,130,121.99148285569,26
41,1983,105,126,132,124.053678468784,27
41,1984,94,112,130,115.675403760762,36
41,1985,102,130,158,136.228758110501,56
41,1986,132,139,145,143.499999999176,13
41,1987,88,116,151,122.168823086079,63
41,1988,88,106,137,115.807703483314,49
41,1989,107,137,165,139.503284938201,58
41,2002,81,124,165,124.967197553879,84
41,2003,93,102,123,109.678808106303,30
41,2004,95,116,128,116.000000001922,33
41,2005,92,106,123,109.189893013195,31
41,2006,92,106,121,111.151015285298,29
41,2007,90,106,121,110.393059627048,31
41,2009,84,93,114,100.615016999388,30
43,1977,93,99,132,110.463483617984,39
43,1978,91,107,124,108.541864531551,33
43,1979,95,106,132,113.874380004975,37
43,1980,90,107,132,109.729176546403,42
43,1981,93,109,126,111.861400792861,33
43,1982,81,102,121,107.17365666316,40
43,1983,95,108,127,112.411078627688,32
43,1984,88,108,120,108.696465574628,32
43,1985,94,112,132,115.942136640415,38
43,1986,90,109,132,113.066437574515,42
43,1987,93,112,128,114.317766165818,35
43,1988,79,103,113,102.664703656281,34
43,1989,81,94,113,99.6197522862317,32
43,1990,86,101,122,103.567969018935,36
43,1991,95,111,129,114.309119697261,34
43,1992,78,97,119,98.5404163998436,41
43,1993,89,104,132,108.850938258075,43
43,1994,96,110,134,115.619730029788,38
43,1995,87,111,122,110.036085651624,35
43,1996,93,115,131,116.863807063056,38
43,1997,85,111,130,110.0082225165,45
43,1998,86,99,122,105.40347576207,36
43,1999,86,102,120,108.397526035546,34
43,2000,88,92,119,102.097107475926,31
43,2001,89,107,131,110.866875781905,42
43,2002,97,117,134,118.163680874416,37
43,2003,79,105,126,106.671371609561,47
43,2004,88,110,127,112.347889450395,39
43,2005,88,116,128,113.898377797092,40
43,2006,88,105,125,108.432020973457,37
43,2007,88,110,122,109.054989446429,34
43,2008,81,116,158,119.651282889541,77
43,2009,87,102,123,106.972965305624,36
43,2011,81,95,121,103.641352973611,40
43,2013,96,107,121,112.412332556603,25
43,2015,90,92,109,98.3171883701339,19
44,1977,111,123,145,129.724574966517,34
44,1978,88,107,129,113.335217317172,41
44,1979,97,107,120,110.8124999996,23
44,1980,81,102,118,105.406690358618,37
44,1981,98,106,132,114.542718249114,34
44,1982,81,99,109,100.019701747614,28
44,1983,89,102,108,104.443190716811,19
44,1984,79,95,112,99.2456296496643,33
44,1985,91,110,123,108.756913699622,32
44,1986,86,106,130,110.238018747326,44
44,1987,85,92,125,103.584442104311,40
44,1988,76,96,116,97.1138609193312,40
44,1989,67,85,108,91.8974727017917,41
44,1991,67,101,146,107.053494237696,79
44,1992,63,87,120,95.5999999645229,57
44,1993,82,92,99,95.6666666529967,17
44,1994,66,92,128,99.9579833608364,62
44,1995,91,116,151,122.311247183236,60
44,2009,116,121,121,121.064466574094,5
44,2011,35,84,121,82.500000010083,86
44,2013,80,113,156,118.999999801813,76
44,2014,61,78,99,81.9999871844473,38
44,2015,101,109,113,110.999999993606,12
45,1977,107,123,137,125.918096200338,30
45,1978,109,131,139,128.424164949725,30
45,1979,101,126,134,125.154299066004,33
45,1980,113,122,138,129.155484757163,25
45,1981,99,118,134,121.637596861182,35
45,1982,99,108,131,115.12882787718,32
45,1983,103,114,128,118.669622291152,25
45,1984,99,114,135,121.83078644107,36
45,1985,104,123,139,124.397393649212,35
45,1986,104,118,130,119.16730563285,26
45,1987,104,109,138,116.465626843118,34
45,1988,94,116,145,121.582754519786,51
45,1989,88,106,133,113.565220325581,45
45,1990,97,106,127,113.452760670333,30
45,1991,101,117,130,118.410987306537,29
45,1992,96,108,123,112.74012154908,27
45,1993,93,112,134,115.336602730501,41
45,1994,95,111,127,112.361906482217,32
45,1995,93,110,131,114.716378861937,38
45,1996,101,116,131,119.647173761613,30
45,1997,100,119,135,121.855042149183,35
45,1998,94,107,129,115.361520480227,35
45,1999,93,109,121,110.568985158066,28
45,2000,98,116,137,120.721978383028,39
45,2001,93,113,137,116.872092613325,44
45,2003,86,109,124,112.415824074275,38
45,2004,97,114,136,121.615196959899,39
45,2005,95,107,124,111.301572780989,29
45,2006,92,112,126,112.840110800757,34
45,2008,95,117,137,119.113031512916,42
45,2009,91,104,124,105.704896109969,33
45,2011,88,106,137,113.705831761916,49
45,2013,100,117,136,121.220078110763,36
45,2015,93,116,134,116.966465625011,41
46,1977,101,115,136,118.879489401772,35
46,1978,100,116,135,118.441301245161,35
47,1977,100,118,132,121.609326517128,32
47,1978,98,111,140,117.768670378842,42
47,1979,103,115,133,118.954788538056,30
47,1980,85,106,137,115.956507719462,52
47,1981,105,117,139,122.204841703275,34
47,1982,105,114,140,121.256770228265,35
47,1983,103,114,127,117.950016506021,24
47,1984,94,106,127,112.372260458957,33
47,1985,110,121,139,125.165418898941,29
47,1986,104,115,158,126.225682518606,54
47,1987,98,116,144,122.391914559296,46
47,1988,96,116,128,118.150262674444,32
47,1989,81,106,123,106.532791876385,42
47,1990,103,116,130,117.036736734928,27
47,1991,107,130,144,130.820758992135,37
47,1992,95,119,128,116.893298825329,33
47,1993,86,109,136,113.556877422891,50
47,1995,96,112,122,110.670112707301,26
47,1996,101,115,137,119.707328363858,36
47,1997,100,113,140,120.457802010284,40
47,1998,95,116,147,120.584085855472,52
47,1999,96,112,132,117.334248419462,36
47,2000,97,117,133,116.877120234861,36
47,2001,91,100,127,109.188928411256,36
47,2002,102,116,147,126.111668036575,45
47,2003,95,112,129,114.667623345387,34
47,2004,91,107,138,113.951521453693,47
47,2005,95,106,130,110.172644760508,35
47,2006,95,106,126,111.74768912047,31
47,2007,74,108,146,115.264038146089,72
47,2011,95,113,127,114.14614644872,32
47,2013,46,92,138,97.5725066701423,92
47,2014,90,102,113,104.159285743263,23
47,2015,94,103,122,108.351335964118,28
48,1977,81,116,132,114.526199861116,51
48,1978,94,108,130,111.590114325799,36
48,1979,101,126,137,124.811929234688,36
48,1980,104,112,137,118.603050718512,33
48,1981,108,122,133,123.273586912306,25
48,1982,90,104,124,108.72415632773,34
48,1983,92,112,130,116.034868561407,38
48,1984,92,118,128,117.736634146501,36
48,1985,99,125,143,123.771857671693,44
48,1986,92,108,130,113.177751483126,38
48,1987,93,125,136,121.169991780011,43
48,1988,96,117,127,116.035652769561,31
48,1989,78,96,113,100.681838260166,35
48,1990,94,107,123,109.840908708527,29
48,1991,108,120,130,124.228571423723,22
48,1992,86,106,128,111.874881400905,42
48,1993,92,109,129,113.637443465363,37
48,1994,98,111,130,117.228456738313,32
48,1995,88,118,132,114.398876365675,44
48,1996,95,113,138,118.960960144793,43
48,1997,95,111,128,114.439464804916,33
48,1998,101,115,132,120.042518608455,31
48,1999,93,103,123,109.887764052545,30
48,2000,95,116,131,116.874658899177,36
48,2001,90,111,130,113.593099989657,40
48,2002,95,116,138,120.565341116762,43
48,2003,81,112,134,110.448314811496,53
48,2004,95,119,133,119.754955546737,38
48,2005,85,105,116,106.07378826752,31
48,2006,90,102,117,105.197302091631,27
48,2007,80,102,126,105.333724095048,46
48,2008,87,107,143,115.906021928185,56
48,2009,86,102,124,105.315027003549,38
48,2013,100,114,137,121.354585025103,37
48,2014,86,105,122,106.675936179555,36
48,2015,85,107,133,110.29663604808,48
49,1977,95,109,123,113.352514395371,28
49,1978,81,116,151,117.066364387287,70
49,1981,89,113,144,118.661738975152,55
49,1982,74,91,102,93.2567105024108,28
49,1983,88,98,116,103.828990559594,28
49,1984,84,100,116,102.75421794295,32
49,1985,95,113,144,120.17003113297,49
49,1986,109,123,131,124.667259433984,22
49,1987,53,95,133,95.0639615297687,80
49,1988,70,103,144,108.045964442152,74
49,1989,76,110,144,113.255619601563,68
49,1990,67,104,144,107.425572636768,77
50,1977,105,123,143,125.721570840182,38
50,1978,69,106,112,103.27573183187,43
51,1977,106,120,143,126.950491339077,37
51,1978,112,120,147,127.958275550615,35
51,1979,94,116,134,119.031531782537,40
51,1980,112,123,131,124.646822591284,19
51,1981,73,117,143,113.733744084601,70
51,1982,74,110,144,111.335390089643,70
51,1983,99,113,136,119.27203446176,37
51,1984,88,109,123,108.186565487238,35
51,1985,119,130,143,136.179803070094,24
51,1986,112,126,143,129.41664259433,31
51,1987,141,149,149,149.000000000036,8
51,1988,69,86,103,89.0429316814544,34
51,1990,97,114,133,116.621171484601,36
51,1991,121,130,140,131.475280294334,19
51,1992,93,102,124,108.666248105192,31
51,1993,116,130,137,130.716046395545,21
51,1994,97,118,129,118.057405870122,32
51,1995,81,109,143,115.39193068744,62
51,1996,120,128,137,131.924671856617,17
51,1997,113,130,146,130.739139041335,33
51,2001,109,125,140,127.024286455109,31
51,2003,95,122,146,122.081178661534,51
51,2004,95,124,151,124.835617250032,56
51,2005,60,112,168,113.715361537398,108
51,2006,99,116,138,121.315179779506,39
51,2007,116,130,137,130.098117032211,21
51,2008,88,114,158,122.386142824551,70
51,2009,92,111,128,112.272932048359,36
51,2011,88,116,135,117.648088499227,47
51,2013,106,126,136,125.893643508911,30
51,2014,88,108,137,113.562800421576,49
51,2015,81,130,172,131.70966282857,91
52,1977,102,123,144,125.866723109393,42
52,1978,87,105,133,110.245282974765,46
52,1979,93,111,130,115.132656714341,37
52,1980,88,112,138,114.349729907282,50
52,1981,90,109,125,111.066767021381,35
53,1977,113,130,148,132.805408422439,35
53,1978,80,105,133,107.480519490839,53
53,1979,93,115,143,121.233555809832,50
53,1980,94,115,149,121.234052638475,55
53,1981,88,109,125,113.194936543789,37
53,1983,87,99,121,106.235755786985,34
53,1984,87,102,122,107.086557091107,35
53,1985,88,107,130,109.210634967633,42
53,1986,89,113,144,119.670814332357,55
53,1987,72,94,125,101.151065946366,53
53,1988,88,102,123,106.975694725719,35
53,1989,72,85,106,92.243478250835,34
53,1990,80,93,106,95.8382988780071,26
53,1991,92,107,124,110.167240041453,32
53,1992,81,97,108,96.6465257310754,27
53,1993,82,102,113,102.916361101131,31
53,1994,85,100,113,104.580027790444,28
53,1995,87,103,113,104.28633468755,26
53,1996,85,101,113,105.900580070252,28
53,1997,74,92,116,98.2887241117737,42
53,1998,82,98,131,103.925333215261,49
53,1999,85,95,109,102.2174293813,24
54,1977,105,124,145,127.105257678088,40
54,1978,105,120,139,126.088904998,34
54,1979,96,116,134,118.576525732425,38
54,1980,102,124,141,124.914959283381,39
54,1981,107,123,134,123.098292794752,27
54,1982,88,112,133,112.595770174781,45
54,1983,98,112,125,115.193454076958,27
54,1984,92,107,131,114.548358613983,39
54,1985,99,114,139,122.267440872681,40
54,1986,92,113,135,120.627078254526,43
54,1988,83,96,130,104.975571740326,47
54,1989,79,101,123,103.125056498819,44
54,1990,87,99,125,105.486815284087,38
54,1991,105,140,172,143.829963734414,67
54,1992,80,103,132,108.417872150584,52
54,1993,91,107,135,114.472222203278,44
54,1994,100,116,128,118.631900360789,28
54,1995,94,112,124,113.515186671655,30
54,1996,88,118,151,121.685675227352,63
54,1997,104,114,123,116.257886593109,19
54,1998,96,116,138,120.371746952297,42
54,2000,88,116,142,117.536724127021,54
54,2002,67,116,155,115.962625014856,88
54,2003,67,109,144,110.188668137703,77
54,2004,97,124,151,127.849612724377,54
54,2005,88,102,130,110.137227458746,42
54,2006,98,112,126,112.906466937964,28
54,2007,95,95,102,101.92796622469,7
54,2008,115,128,144,130.127189513994,29
54,2009,85,102,123,104.721453413224,38
54,2011,74,95,116,98.2199142267233,42
55,1977,11,58,104,59.7421069736269,93
55,1979,88,109,137,113.521767406763,49
55,1980,88,123,158,126.836658747624,70
55,1981,73,109,137,108.052544005584,64
55,1982,91,116,144,117.590352588912,53
55,1983,95,109,123,112.761764781381,28
55,1984,88,102,115,104.308290988131,27
55,1985,99,120,151,126.037375606484,52
56,1976,81,102,130,105.58467702274,49
56,1977,107,123,150,129.258663561707,43
57,1977,95,123,144,123.801258349765,49
57,1978,95,116,134,117.61416131015,39
57,1979,79,116,149,120.31722365208,70
58,1977,95,102,116,108.443760681053,21
58,1978,103,107,126,116.031819734987,23
59,1977,109,133,158,135.807161282925,49
59,1978,109,127,142,129.949594761106,33
59,1979,96,119,134,121.808474378121,38
59,1980,102,124,147,127.971739572434,45
59,1981,103,116,140,123.088678274234,37
59,1982,85,107,126,112.230564374537,41
59,1983,92,111,125,115.759173667944,33
59,1984,96,108,136,117.674651428258,40
59,1985,101,114,137,120.984879583039,36
59,1986,92,108,127,113.488912067817,35
59,1987,95,116,137,122.076545636619,42
59,1988,91,111,137,115.563520016601,46
59,1989,83,105,125,108.044117081273,42
59,1990,87,103,122,105.975768110502,35
59,1991,98,119,133,119.260533513785,35
59,1992,90,100,121,105.548739625276,31
59,1993,86,104,130,111.521589198559,44
59,1994,91,100,123,106.847015177009,32
59,1995,95,107,127,110.41957643547,32
59,1996,98,110,130,117.369055342513,32
59,1997,102,112,123,115.023292722105,21
59,1998,96,117,134,117.259668612878,38
59,1999,93,114,144,119.861847354086,51
59,2008,95,115,144,122.045523472966,49
59,2009,81,93,136,106.642971955014,55
59,2011,67,95,137,101.173201117604,70
59,2013,96,112,130,115.808592566683,34
59,2014,81,111,127,110.052494829139,46
59,2015,85,100,128,108.598931132094,43
60,1977,120,134,151,137.543123628096,31
60,1978,112,125,146,131.037910692446,34
60,1979,103,123,139,123.550092947825,36
60,1980,122,130,142,133.309661708256,20
60,1981,101,123,144,126.899999725121,43
60,1982,105,123,137,125.11607900876,32
60,1983,109,123,134,122.574795385139,25
60,1984,102,121,143,125.275077188756,41
60,1985,94,131,171,136.330482258971,77
60,1986,87,119,144,120.48023966212,57
60,1987,107,125,140,127.282650885826,33
60,1988,99,133,151,132.088518642487,52
60,1989,100,107,130,115.162346507895,30
60,1990,102,114,132,116.303436680163,30
60,1991,111,120,130,122.811332760652,19
60,1992,97,111,122,112.10093703125,25
60,1993,109,123,149,130.323072836888,40
60,1994,109,123,140,126.445870857549,31
60,1995,103,118,130,121.36027161649,27
60,1996,102,126,142,125.055306511093,40
60,1997,100,118,130,120.364782854562,30
60,1998,107,132,146,131.03583179229,39
60,1999,109,117,130,120.911473912192,21
60,2000,109,121,145,129.485848598918,36
60,2001,107,124,144,129.705611313575,37
60,2002,101,122,143,126.871791529188,42
60,2003,97,114,131,117.963267316765,34
60,2004,96,125,144,123.68233019367,48
60,2005,95,109,137,117.281835565491,42
60,2006,88,106,127,112.942427101518,39
60,2007,104,115,145,122.999546244774,41
60,2008,112,121,137,126.066821605096,25
60,2009,88,101,130,110.633411120628,42
60,2011,89,130,172,130.910565103202,83
60,2013,88,108,136,113.153914794282,48
60,2014,88,102,122,109.025800559537,34
60,2015,81,130,165,130.879080041834,84
61,1977,102,116,130,118.566943330185,28
61,1978,88,116,158,123.706795097324,70
61,1979,108,130,158,136.185658015963,50
61,1980,95,124,148,126.168957331643,53
61,1981,88,117,153,120.549847628717,65
61,1982,99,111,115,112.600000017709,16
61,1983,102,108,122,112.414972945558,20
61,1984,99,109,123,114.119934846734,24
61,1985,112,126,137,127.857369697094,25
61,1986,109,126,134,126.119365446228,25
61,1987,81,109,139,114.029229763722,58
61,1988,81,109,144,111.967799287006,63
61,1989,103,109,116,114.527234781991,13
61,1990,95,107,121,111.761001277834,26
61,1991,97,112,121,112.792122385313,24
61,1992,102,102,109,108.954917434358,7
61,1993,81,110,149,116.410034577031,68
61,1994,123,129,129,129.431536711503,6
61,1995,101,109,122,113.398624038442,21
61,1996,88,123,151,122.862567059856,63
61,1997,60,116,158,115.641881431747,98
61,1999,81,117,151,117.718198829243,70
61,2000,102,117,130,120.586098445395,28
61,2001,79,117,158,122.894930119408,79
61,2002,108,130,158,135.286163510837,50
61,2003,81,113,151,117.164276744957,70
61,2005,78,115,151,118.850201846849,73
61,2006,105,110,116,112.972783599003,11
61,2007,90,108,137,113.816997327971,47
61,2008,93,113,136,117.129532634505,43
61,2009,61,93,127,98.3224320784325,66
61,2011,89,118,151,124.627278678025,62
61,2013,100,111,126,115.609439424581,26
61,2015,92,123,151,126.498612447595,59
62,1977,102,123,145,125.658097737959,43
62,1978,104,119,144,123.882913543855,40
62,1979,96,109,130,114.007594321837,34
62,1980,94,112,136,115.643062607895,42
62,1981,104,119,136,124.774844746612,32
62,1982,93,108,134,113.685852540478,41
62,1983,99,116,134,117.350434623376,35
62,1984,99,120,136,121.192424301148,37
62,1985,99,113,134,119.237326088782,35
62,1986,100,115,136,120.768865894828,36
62,1987,100,117,136,122.036223643163,36
62,1988,91,118,137,115.461919132174,46
62,1989,91,108,123,109.47207951235,32
62,1990,88,99,121,106.182672564766,33
62,1991,100,117,136,120.905472371128,36
62,1992,85,106,122,110.047504173047,37
62,1993,89,97,125,105.109383237685,36
62,1994,92,111,125,115.469269829122,33
62,1995,97,104,116,109.423371059888,19
62,1996,95,107,123,110.360638064875,28
62,1997,78,105,123,106.185582726064,45
62,1998,92,113,147,121.855092807965,55
62,1999,91,104,120,107.338840071911,29
62,2000,88,109,133,111.691040813649,45
62,2001,94,117,132,117.538751757249,38
62,2002,95,116,135,118.279535435475,40
62,2003,88,100,130,110.556267048482,42
62,2004,90,112,130,115.354319377751,40
62,2005,89,109,123,110.157211775203,34
62,2006,91,103,123,110.016548303671,32
62,2007,74,116,158,119.624483117984,84
62,2013,99,113,139,120.789256074499,40
62,2015,91,102,122,105.876008698608,31
63,1977,93,130,165,129.474319414192,72
64,1977,98,126,140,125.446497029566,42
64,1978,112,119,137,124.36565584684,25
64,1983,106,120,132,123.190191979159,26
64,1984,92,108,121,112.902534871457,29
64,1985,101,114,141,122.533654818241,40
64,1986,105,126,136,124.454394316519,31
64,1987,99,113,139,122.179127715691,40
64,1988,99,109,130,116.008880643824,31
64,1989,88,104,125,110.019385448308,37
64,1990,95,116,130,116.983305998033,35
64,1991,102,123,149,127.213112843579,47
64,1992,98,102,114,109.87735661809,16
64,1993,81,116,144,118.455669329085,63
64,1994,102,113,130,118.412073780957,28
64,1995,104,118,139,123.590590141388,35
64,1996,101,116,130,118.845488833164,29
64,1997,101,113,123,116.941275193416,22
64,1998,100,124,137,121.563710619872,37
64,1999,100,117,132,118.496958872687,32
64,2000,104,115,128,120.415760499783,24
64,2001,92,113,132,116.128930817505,40
64,2002,106,124,137,127.745847844254,31
64,2003,97,118,128,116.7597767073,31
64,2004,96,112,128,114.667190345495,32
65,1978,107,133,151,133.916919986403,44
65,1979,102,118,147,125.998575083827,45
65,1980,109,132,144,131.83755649075,35
65,1981,99,124,139,123.59371886042,40
65,1982,98,109,130,116.046529702264,32
65,1983,92,112,132,118.864898966962,40
65,1984,102,118,133,119.883743193219,31
65,1985,109,123,137,125.628989106968,28
65,1986,98,115,137,119.369234901964,39
65,1987,109,132,143,131.620304022711,34
65,1988,96,118,139,120.122309378414,43
65,1989,86,108,129,111.604960082362,43
65,1990,88,110,135,115.080271245309,47
65,1991,101,123,141,128.119356025659,40
65,1992,97,113,137,117.730482076286,40
65,1993,93,119,135,118.871242444024,42
65,1994,98,112,124,112.84939609159,26
65,1995,97,110,132,117.96041702108,35
65,1996,96,124,141,123.720525031037,45
65,1997,95,116,136,120.094568645804,41
65,1998,105,113,136,121.24311077987,31
65,1999,85,106,133,110.718992348037,48
65,2000,87,108,137,115.940084585542,50
65,2001,94,117,137,118.488892351852,43
65,2002,87,116,138,116.941433197656,51
65,2003,86,101,125,105.770697773996,39
65,2004,89,116,139,119.04048528942,50
65,2005,95,119,133,119.04026356165,38
65,2006,95,109,130,114.519633123687,35
65,2007,86,118,129,115.180342362191,43
65,2008,95,119,130,119.863399515058,35
65,2009,80,109,139,112.179079796149,59
65,2011,81,102,132,108.180625539105,51
65,2014,78,99,120,106.02886448517,42
66,1978,93,119,132,118.871214769155,39
66,1979,100,113,135,120.845349442651,35
66,1980,101,115,127,118.977935055676,26
66,1981,95,116,138,118.543131062649,43
66,1982,99,115,135,119.710498547878,36
66,1983,102,119,128,119.853740210695,26
66,1984,92,108,121,111.224358974755,29
66,1985,104,117,131,117.666650412736,27
66,1986,99,106,133,114.397058661883,34
66,1987,99,114,127,118.118314916278,28
66,1988,85,106,120,109.818843249744,35
66,1989,90,100,120,106.200149196464,30
66,1990,94,116,129,115.602594679852,35
66,1991,95,115,134,117.205818406544,39
66,1992,85,108,121,108.076108489944,36
66,1993,98,108,134,113.92070485734,36
66,1994,92,116,127,115.866011632242,35
66,1995,101,112,120,113.363639690676,19
66,1996,98,107,120,113.030462501814,22
67,1978,81,120,152,122.043416180454,71
67,1979,87,125,165,127.948845916458,78
67,1980,83,117,145,116.475219133966,62
67,1981,101,123,131,122.886262180644,30
67,1982,95,109,124,110.183622560829,29
67,1983,95,108,121,112.699005803359,26
67,1984,99,123,141,126.265346941171,42
68,1978,102,123,147,129.942428651695,45
69,1978,112,126,147,129.981736688882,35
69,1979,102,117,140,119.856945748923,38
69,1980,112,122,140,126.017624481128,28
69,1981,94,116,137,117.325073630991,43
69,1982,96,112,124,113.316975940903,28
69,1983,105,116,130,119.295452884793,25
69,1984,99,123,135,126.214834513704,36
69,1985,98,114,139,120.703779378323,41
69,1986,94,116,140,116.526242022276,46
69,1987,99,109,138,116.7789333508,39
69,1988,94,116,138,118.521257488856,44
69,1989,84,103,124,107.370461899118,40
69,1990,81,94,114,101.248269360347,33
69,1991,102,116,130,119.870206246454,28
69,1992,95,112,122,111.835163201733,27
69,1993,93,116,128,118.381267447461,35
69,1994,88,102,116,105.357764963104,28
69,1995,97,103,115,110.479384795219,18
69,1996,96,110,124,111.260589391464,28
69,1997,95,112,131,115.100211978502,36
69,1998,95,110,128,113.974957305395,33
69,1999,88,93,109,100.030326237145,21
69,2000,87,108,133,112.607581807868,46
69,2001,85,100,124,107.210188223614,39
69,2002,80,95,109,98.1664129274194,29
69,2003,84,102,129,109.141270380062,45
69,2004,86,110,128,113.802060503095,42
69,2005,87,102,124,107.676491802378,37
69,2006,78,103,115,103.687705824538,37
69,2007,89,110,127,109.669088157549,38
69,2008,88,117,144,118.180859270333,56
69,2009,82,92,124,101.439064203628,42
69,2011,72,101,122,102.313233131104,50
69,2013,97,116,130,116.412729655579,33
69,2014,80,99,120,103.475496634956,40
69,2015,86,108,131,112.119337957833,45
70,1978,112,139,165,141.447915584636,53
70,1979,103,133,156,136.01832607101,53
70,1980,105,130,158,133.597258558597,53
70,1981,109,132,146,131.568047306709,37
70,1982,95,119,144,123.239082399131,49
70,1983,100,113,134,117.274189988262,34
70,1984,99,118,139,121.408341247097,40
70,1985,100,115,144,121.374923917564,44
70,1986,103,125,150,126.83602136137,47
70,1987,98,114,143,122.745804675354,45
70,1988,85,116,146,117.753349349787,61
70,1989,85,107,134,112.214285714286,49
70,1990,91,109,130,115.155824503405,39
70,1991,101,117,148,122.607355698805,47
70,1992,84,110,139,113.079016200929,55
70,1993,90,109,135,116.15579754918,45
70,1994,104,113,144,123.400765483486,40
71,1978,98,132,164,132.718104272787,66
71,1979,108,140,162,138.488512945879,54
71,1980,90,145,165,138.888783104369,75
71,1981,111,132,158,137.576185139908,47
71,1982,96,131,149,128.071274926731,53
71,1983,101,129,149,127.805344146319,48
71,1984,99,136,155,135.130839700489,56
71,1985,112,135,166,141.276256192511,54
71,1986,106,142,163,143.559242779524,57
71,1987,100,143,167,143.928743390554,67
71,1988,103,137,159,137.841348792936,56
71,1989,79,113,141,118.487644236132,62
71,1990,102,123,152,129.646824806596,50
71,1991,123,144,158,144.121705921822,35
71,1992,110,132,151,135.167144887092,41
71,1993,102,128,151,132.065786692633,49
71,1994,106,123,142,128.667657889291,36
71,1995,99,124,141,126.709733980284,42
71,1996,108,127,150,131.619246155773,42
71,1997,116,136,148,135.913838116693,32
71,1998,115,135,156,138.467965419539,41
71,1999,108,128,150,130.958847740688,42
71,2000,103,132,152,131.731936420401,49
71,2001,106,132,151,132.981470724608,45
71,2002,103,132,152,131.73193642044,49
71,2003,96,124,141,123.942335413737,45
71,2004,102,127,151,132.070747182245,49
71,2005,95,120,153,125.674632109524,58
71,2006,105,133,152,132.594791553533,47
71,2007,101,137,165,137.313298175938,64
71,2008,92,128,158,130.727558762609,66
71,2009,95,127,151,130.229410271346,56
71,2011,88,131,158,131.539693470507,70
71,2013,100,133,158,134.814787474095,58
71,2014,86,114,142,119.436542960599,56
71,2015,91,124,151,124.545739156716,60
72,1978,91,104,124,109.142506872045,33
72,1979,95,106,137,116.208046932065,42
72,1980,93,112,122,114.582251280009,29
72,1981,93,118,131,115.97312562491,38
72,1982,81,100,121,104.446388657099,40
72,1983,95,107,117,108.803506388621,22
72,1984,94,106,120,108.936984501279,26
72,1985,100,114,130,120.076394021033,30
72,1986,100,117,127,119.305682564408,27
72,1987,100,114,135,117.1711672219,35
72,1988,84,93,118,102.719032838263,34
72,1989,91,102,114,102.638343017397,23
72,1990,86,104,120,108.037106276557,34
72,1991,92,111,120,114.179029249515,28
72,1992,79,96,115,101.554949457324,36
72,1993,89,104,121,108.712722332652,32
72,1994,99,114,129,117.447320808437,30
72,1995,93,112,115,108.361178452186,22
72,1996,96,116,134,118.835387116028,38
72,1997,97,110,120,110.730032862955,23
72,1998,91,100,123,105.650118931008,32
72,1999,86,103,113,105.602662704285,27
72,2000,87,102,117,104.71904761846,30
72,2001,96,107,122,111.237885188235,26
72,2002,94,109,127,115.356911041413,33
72,2003,86,100,117,102.458154362906,31
72,2004,86,102,122,107.141073913378,36
72,2005,86,112,130,112.535628218489,44
72,2006,91,102,125,108.534736612216,34
72,2007,95,116,130,115.634250568624,35
72,2008,91,102,129,109.303862642677,38
72,2009,81,95,116,101.636748212557,35
72,2011,89,100,121,107.403358470217,32
72,2013,102,107,129,115.102756428658,27
72,2014,87,98,113,101.579848082316,26
72,2015,94,106,130,114.142856470275,36
73,1978,97,103,116,110.198144751651,19
73,1979,95,106,126,112.166355852721,31
73,1980,109,124,136,124.256102485037,27
73,1981,82,116,151,117.923864716642,69
73,1982,81,101,129,105.857612116268,48
73,1983,96,108,121,112.167944582565,25
73,1984,92,108,123,109.39558353016,31
73,1985,97,112,131,115.374878423679,34
73,1986,89,125,152,122.727599855942,63
73,1987,96,109,127,113.549775618653,31
73,1988,85,106,132,112.55339958056,47
73,1989,79,113,132,110.274878639848,53
73,1990,88,103,116,106.144334123759,28
73,1991,101,129,148,127.67426005075,47
73,1992,85,103,132,110.278688334232,47
73,1994,109,123,135,126.050146572023,26
73,1996,85,125,150,122.4967685756,65
74,1978,72,107,141,109.540097124667,69
74,1979,99,116,127,118.293918407572,28
74,1980,69,104,152,110.993044216551,83
75,1978,112,130,151,135.143508459174,39
76,1979,87,123,164,128.523706537964,77
76,1980,94,123,155,130.27366417924,61
76,1981,74,118,148,117.318697585656,74
76,1982,96,108,120,112.590802813081,24
76,1983,94,113,130,116.63890581704,36
76,1984,95,114,131,116.296291141015,36
76,1985,104,114,139,120.037625728828,35
76,1986,91,106,130,114.92087028431,39
76,1987,94,109,137,115.531300695053,43
76,1988,88,118,145,119.087973537446,57
76,1989,86,101,127,108.214915135127,41
76,1990,90,109,130,112.724968023711,40
76,1991,101,126,138,125.791009555157,37
76,1992,89,111,137,115.155284828956,48
76,1993,87,110,130,115.475940806698,43
76,1994,92,108,128,112.851513553971,36
76,1995,102,130,151,131.467683129814,49
76,1996,102,123,144,124.976958210832,42
76,1997,100,114,129,116.960969380271,29
76,1998,77,116,158,121.059395836393,81
76,1999,96,104,124,111.66879457173,28
76,2000,102,126,137,125.117057485336,35
76,2001,102,117,137,121.704838323352,35
76,2002,80,106,130,109.59134706754,50
76,2003,95,113,136,119.417611908257,41
76,2004,95,118,139,120.197077090851,44
76,2005,102,116,133,120.045496736688,31
76,2006,91,118,151,122.481767040936,60
77,1979,100,113,133,119.132443180532,33
77,1980,96,110,134,115.738522172519,38
77,1981,95,109,127,114.150441975357,32
77,1982,99,115,127,118.261609161611,28
77,1983,102,118,128,118.595508796997,26
77,1984,92,108,121,110.017006799763,29
77,1985,100,116,134,120.228416387312,34
77,1986,99,115,134,118.716955864049,35
77,1987,92,114,137,120.770698527503,45
77,1988,97,106,127,113.597660883454,30
77,1989,90,107,120,108.240597251601,30
77,1990,94,109,122,113.297967036718,28
77,1991,103,115,129,118.566432054899,26
77,1992,85,100,129,107.355449009716,44
77,1993,98,114,134,118.227777792112,36
77,1994,99,116,127,119.08906803519,28
77,1995,95,106,120,110.031706598189,25
77,1996,99,115,120,115.312324625188,21
78,1992,85,100,109,101.309075631164,24
78,1997,99,112,112,112.000000000949,13
79,1979,109,132,151,134.088421193157,42
79,1980,111,130,146,132.155155899895,35
79,1981,108,120,138,125.735562814382,30
79,1982,109,114,139,120.99795015205,30
79,1983,108,120,147,126.455545080184,39
79,1985,109,137,172,142.382786742307,63
79,1986,112,123,142,129.227402637646,30
79,1987,113,131,153,134.395260356698,40
79,1988,94,113,136,119.93841715179,42
79,1989,94,118,147,121.122880623138,53
79,1990,100,124,145,125.580351529021,45
79,1991,108,124,146,126.773653679072,38
79,1992,96,109,138,116.726571494109,42
79,1994,98,120,143,123.110743647176,45
80,1979,101,126,137,128.613470187095,36
80,1980,81,109,137,112.220541096591,56
81,1979,88,103,125,111.416642398009,37
81,1980,88,112,131,115.508114894301,43
81,1981,101,117,138,120.86482532839,37
81,1982,90,112,127,113.825793828627,37
81,1983,95,109,127,113.748777671026,32
82,1979,94,112,132,118.398779041594,38
82,1980,102,116,137,121.974187087046,35
82,1981,101,117,138,119.533309755927,37
82,1982,96,110,127,114.22288804183,31
82,1983,74,112,151,113.974199479483,77
82,2001,109,117,123,121.622611173558,14
82,2002,81,123,155,123.581527828077,74
82,2003,85,106,127,112.513209160825,42
82,2004,83,109,151,117.259922054158,68
82,2005,46,95,137,94.8359918624513,91
82,2006,74,88,102,90.4692652098497,28
82,2007,95,128,144,127.233092090026,49
82,2008,67,109,151,114.258612201796,84
82,2009,86,101,123,108.964002734669,37
82,2011,89,96,118,104.253549670838,29
82,2014,86,100,115,103.6852722089,29
82,2015,98,106,128,115.409467109696,30
83,1979,103,137,158,136.802319806453,55
83,1980,102,132,155,130.695328761261,53
83,1981,99,132,150,131.627605598238,51
83,1982,78,109,134,112.881390893768,56
83,1983,102,116,137,119.938132615724,35
83,1984,95,114,141,119.638751562083,46
83,1985,99,130,159,131.560300391062,60
83,1986,105,139,165,136.380693095256,60
83,1987,104,134,157,133.967885143002,53
83,1988,103,131,159,134.539601816244,56
83,1989,81,107,130,110.027693526609,49
83,1990,95,116,144,120.513342449271,49
83,1991,112,130,149,132.936582090599,37
83,1992,95,121,146,123.48635475754,51
83,1994,102,126,144,126.937679427981,42
83,1995,90,115,130,115.162852013794,40
83,1996,85,116,136,118.728044225082,51
83,1997,100,116,140,120.896774488088,40
83,1998,98,126,147,128.284308440129,49
83,1999,97,115,137,119.888120933648,40
83,2000,112,132,151,132.707506517229,39
83,2001,109,123,144,128.189428689191,35
83,2002,106,134,155,135.132765796552,49
83,2003,100,130,148,129.621864572333,48
83,2004,111,128,148,133.526492897966,37
83,2005,102,129,150,129.267326960381,48
83,2006,99,125,149,126.797856513193,50
83,2007,102,138,162,138.127551013124,60
83,2008,114,137,156,141.611283502526,42
83,2009,97,123,158,128.239669164064,61
83,2011,87,124,149,121.916850986962,62
83,2014,85,108,138,114.549381176208,53
83,2015,85,116,159,123.886041385524,74
84,1979,95,116,137,121.595375143323,42
84,1980,87,107,139,116.388008192888,52
84,1981,98,117,137,119.22559932569,39
84,1982,81,99,124,105.713545669522,43
84,1983,89,100,121,107.969218811264,32
84,1984,88,112,131,111.640297406421,43
84,1985,91,109,132,113.566071929372,41
84,1986,104,115,137,121.004983944872,33
84,1987,93,109,127,112.85415980569,34
84,1988,83,103,123,108.148965199891,40
84,1989,81,94,115,98.5151661073329,34
84,1990,77,94,115,99.4794285598431,38
84,1991,101,120,134,122.451215683314,33
84,1992,88,108,120,107.69500509656,32
84,1993,76,108,144,112.898066274346,68
84,1994,100,107,127,114.590074666196,27
84,1995,89,101,115,104.906739401837,26
84,1996,95,107,127,113.238284419201,32
84,1997,88,106,132,108.529619493614,44
84,1998,74,109,137,109.587025518916,63
84,1999,85,99,127,107.976630190993,42
84,2000,88,102,130,110.029342582245,42
84,2001,86,107,121,109.541482780549,35
84,2002,79,104,127,107.003132678958,48
84,2003,78,106,128,109.46406337764,50
84,2004,80,104,127,107.431111100587,47
84,2005,88,95,121,105.357794411574,33
84,2006,79,93,115,102.157558355279,36
84,2007,80,88,110,96.8385352069249,30
84,2008,84,102,130,106.618425203696,46
84,2009,75,96,114,99.2883821401,39
84,2011,81,102,124,105.298165879877,43
84,2013,92,113,134,115.380066391108,42
84,2014,78,106,134,111.009675808946,56
84,2015,85,100,123,105.344459917235,38
85,1979,109,120,147,127.638949099404,38
85,1980,88,132,165,129.701645866668,77
85,1981,109,124,134,126.535982842574,25
85,1982,88,102,121,108.019498656012,33
85,1983,95,112,129,117.40342889765,34
85,1984,91,107,138,112.42442973314,47
85,1985,106,125,137,125.438009739478,31
85,1986,95,107,130,116.478586741414,35
85,1987,109,132,141,130.973516353673,32
85,1988,95,127,157,133.121292525317,62
85,1989,82,111,137,112.991867351589,55
85,1992,87,107,128,112.75401547215,41
85,1993,81,126,155,123.577981148715,74
85,1995,92,111,133,117.815833348886,41
85,1996,107,126,136,125.417502606671,29
85,1997,99,113,134,122.678461346941,35
85,1998,74,109,151,113.840211460408,77
85,1999,87,109,124,110.353631802741,37
85,2000,98,113,134,120.750202675276,36
85,2001,104,113,144,121.5696326299,40
85,2002,101,117,149,124.631222681713,48
85,2003,98,107,135,115.548911730347,37
85,2004,111,121,137,125.858566187004,26
85,2005,99,116,138,122.174031942854,39
85,2006,90,108,126,111.009847695271,36
85,2007,102,122,139,125.336256876274,37
85,2008,95,116,133,119.416718028516,38
85,2009,95,107,139,116.867996120684,44
85,2011,70,119,158,117.715046052894,88
85,2013,100,117,143,121.750908650089,43
85,2014,91,108,120,109.78234819163,29
85,2015,94,115,138,117.703258983623,44
86,1979,93,107,122,111.90751678223,29
86,1980,74,106,129,105.253478766426,55
86,1981,90,111,137,116.963123915846,47
86,1982,78,99,125,107.17668014656,47
86,1983,95,108,127,113.346233606427,32
86,1984,87,100,121,105.429617484565,34
86,1985,93,115,128,115.195646011195,35
86,1986,93,112,123,113.530864418881,30
86,1987,89,109,131,112.12583451007,42
86,1988,86,110,128,113.33798887966,42
86,1989,79,85,99,93.0911129673992,20
86,1990,78,93,116,99.2297297387291,38
86,1991,101,113,136,120.814235967637,35
86,1992,88,97,116,103.455777729812,28
86,1993,81,94,119,101.597075554959,38
86,1994,86,110,123,110.460065123676,37
86,1995,86,100,113,103.225130669223,27
86,1996,98,107,121,111.84101672549,23
86,1997,84,99,130,106.488208715778,46
86,1998,81,100,122,106.186608754021,41
86,1999,79,100,121,105.208183542973,42
86,2000,87,110,127,110.107718814325,40
86,2001,85,104,120,109.843243171639,35
86,2002,87,106,127,109.801623763897,40
86,2003,82,100,118,103.558659103564,36
86,2004,86,101,122,107.539403910166,36
86,2005,87,95,123,104.401227587944,36
86,2006,74,93,120,100.895984510802,46
86,2007,74,98,127,101.830807255803,53
86,2008,86,106,128,111.592893133488,42
86,2009,81,93,116,100.00233800904,35
86,2011,74,95,122,99.8742531335219,48
86,2013,88,103,123,108.22343742248,35
86,2014,88,101,120,104.401905524326,32
86,2015,81,101,129,105.08182216412,48
87,1979,111,123,133,126.332140452212,22
87,1980,89,122,161,124.983471462645,72
87,1981,109,118,137,124.038918117613,28
87,1982,99,110,120,115.928035064783,21
87,1983,106,123,138,123.195340986843,32
87,1984,102,119,136,122.506175821228,34
87,1985,114,130,143,133.918134120093,29
87,1986,87,115,151,122.798206863988,64
87,1988,94,117,127,115.986981984336,33
87,1989,80,102,132,108.810228861527,52
87,1990,107,122,146,126.882394105401,39
87,1991,109,124,137,123.484418135349,28
87,1992,101,118,129,119.404791074533,28
87,1993,95,128,165,132.815154126531,70
87,1995,112,123,136,125.272865647439,24
87,1996,107,120,144,124.883162280542,37
87,1997,102,116,128,120.128115685272,26
89,1979,96,118,140,120.342510664975,44
89,1980,90,114,138,117.58965607363,48
89,1981,99,124,135,124.91158023121,36
89,1982,81,99,124,105.507271654632,43
89,1983,100,116,129,116.541396482659,29
89,1984,92,113,134,116.122218368791,42
89,1985,94,111,128,116.117579912679,34
89,1986,92,116,142,121.440508685852,50
89,1987,99,122,136,122.930434775781,37
89,1988,91,106,128,111.373558507109,37
89,1989,79,93,120,99.813432829317,41
89,1990,81,99,134,108.291457284063,53
89,1991,101,120,141,125.439156074522,40
89,1992,82,103,129,108.868327381956,47
89,1993,86,108,129,113.134615385552,43
89,1994,92,113,142,117.852543667612,50
89,1995,86,99,128,108.589655172481,42
89,1996,96,125,143,122.565331782888,47
89,1997,85,114,134,115.524933911369,49
89,1998,89,106,141,114.803813487641,52
89,1999,93,115,135,117.004854369551,42
89,2000,88,113,134,115.288990810446,46
89,2001,94,114,136,116.795737769039,42
89,2002,87,113,135,114.26027400497,48
89,2003,78,106,130,112.490227934267,52
89,2004,88,114,134,115.893697797789,46
89,2005,88,106,137,113.336363632635,49
89,2006,92,116,127,115.210185926586,35
89,2007,80,104,127,107.054686329806,47
89,2008,91,114,133,115.266059935465,42
89,2009,85,116,134,113.082848529047,49
89,2011,82,102,132,108.494562128502,50
89,2014,87,122,140,120.141675728132,53
89,2015,92,119,137,120.324624706654,45
90,1979,103,116,135,122.820298818539,32
91,1979,88,109,123,110.768822665528,35
91,1980,81,93,129,104.342800124848,48
91,1981,88,119,137,117.298592132011,49
91,1982,81,93,111,99.1248945146824,30
91,1983,96,103,109,105.534103265394,13
91,1984,81,108,114,106.892053841422,33
91,1985,95,106,116,108.666508371253,21
91,1986,95,106,115,107.511806067555,20
91,1987,92,102,130,111.939093346082,38
91,1988,91,107,120,108.305342402121,29
91,1989,74,97,109,96.7539832223577,35
91,1990,83,102,116,102.462682434021,33
91,1991,102,118,130,119.117693641604,28
91,1992,74,99,133,104.866746850007,59
91,1993,82,98,126,104.534710003633,44
91,1994,96,110,125,112.409108447853,29
91,1995,88,95,111,100.114475788277,23
91,1996,60,101,136,101.636416081354,76
91,1997,74,102,121,104.89092028079,47
91,1998,85,107,121,107.206126613052,36
91,1999,83,93,119,102.341990222648,36
91,2000,80,109,122,109.177758373159,42
91,2001,87,103,121,105.847368421053,34
91,2002,85,108,123,109.862537905536,38
91,2003,80,97,114,101.104927877985,34
91,2004,91,104,123,108.94696061759,32
91,2005,82,94,116,101.380486887857,34
91,2006,81,93,108,100.870130387142,27
91,2007,67,88,110,94.2872355619537,43
91,2008,78,92,121,101.665919221417,43
91,2009,81,95,111,97.5950407130053,30
91,2011,74,94,118,98.9256499044648,44
91,2013,96,109,113,107.966396338773,17
91,2014,81,95,107,98.1933247629203,26
91,2015,78,101,122,103.70706064604,44
92,1979,115,131,157,137.223623978866,42
92,1980,119,137,161,139.956826945824,42
92,1981,109,128,146,132.026498077589,37
92,1982,110,121,145,126.303531754982,35
92,1983,105,112,131,120.13811296069,26
92,1984,102,115,135,118.997054855491,33
92,1985,102,123,152,130.270717648464,50
92,1986,105,125,142,127.03828143064,37
92,1987,111,132,150,132.670472218327,39
92,1988,94,123,148,124.725316754638,54
92,1989,96,109,133,116.276688767021,37
92,1990,104,123,144,125.068339146501,40
92,1991,107,129,155,135.426805091099,48
92,1992,96,113,142,120.807665936985,46
92,1993,117,137,157,139.320101892497,40
92,1994,115,129,148,135.321862741586,33
92,1995,101,122,137,123.437499992208,36
92,1996,108,130,159,134.499417927901,51
92,1997,110,127,141,128.864347543131,31
92,1998,106,127,148,130.417956655906,42
92,1999,99,120,138,122.558049169974,39
92,2000,109,129,143,131.951280902989,34
92,2001,96,130,158,130.997024522578,62
92,2002,123,130,137,134.305017984575,14
92,2003,88,123,165,129.289785659693,77
92,2004,102,123,151,128.306633289471,49
92,2005,111,123,137,127.237504360844,26
92,2006,105,125,143,129.193116692107,38
92,2007,108,130,151,133.605606045677,43
92,2008,119,130,144,134.956559586033,25
92,2009,95,121,158,129.000561510845,63
92,2011,109,137,172,142.003016523496,63
92,2013,102,130,158,132.545958554066,56
92,2014,106,120,137,122.455219965586,31
92,2015,114,135,150,137.326329251014,36
93,1979,102,125,142,129.181461352563,40
93,1980,97,131,153,130.27459254792,56
93,1981,98,127,156,132.615000362921,58
93,1982,81,124,149,125.828397630122,68
93,1983,99,120,144,126.48445484947,45
93,1984,102,126,141,126.432643514321,39
93,1985,100,138,163,139.384209431226,63
93,1986,100,139,162,138.69264771107,62
93,1987,93,129,161,130.579579114465,68
93,1988,90,138,163,134.580548052689,73
93,1989,79,114,142,116.059553607413,63
93,1990,106,129,151,132.53937680979,45
93,1991,120,141,158,141.970171262874,38
93,1992,114,128,143,133.278019710562,29
93,1993,114,141,155,140.363746378338,41
93,1994,99,121,142,126.156321334076,43
93,1996,110,127,150,133.716022568729,40
93,1997,101,130,143,128.774680544558,42
93,1998,111,135,150,133.245335594092,39
93,1999,99,127,151,127.380982343513,52
93,2000,102,127,151,130.620005787806,49
93,2001,107,135,163,140.616474884282,56
93,2002,113,137,155,138.992060632338,42
93,2003,106,131,144,132.447568708987,38
93,2004,114,127,153,134.394854336901,39
93,2005,106,129,155,134.229574992385,49
93,2006,102,128,163,135.746369014865,61
93,2007,120,147,159,146.436632508531,39
93,2008,118,137,165,142.672127538719,47
93,2009,85,135,161,134.223360914271,76
93,2011,93,136,162,136.781038181101,69
93,2013,99,123,155,129.965811767637,56
93,2014,78,113,150,119.722788282016,72
93,2015,85,122,155,124.041646908795,70
94,1979,92,111,137,116.118810158508,45
95,1979,92,109,140,118.252372594458,48
95,1980,81,112,130,110.657398728068,49
95,1981,98,109,127,112.364982429745,29
95,1982,78,99,125,103.110236206935,47
95,1983,95,106,125,111.401613864577,30
95,1984,94,109,121,112.920731693497,27
95,1985,106,123,143,127.196133060264,37
95,1986,101,113,130,118.083281092157,29
95,1987,101,122,142,123.949999999403,41
95,1988,96,114,137,119.33870966459,41
95,1989,86,101,123,104.298241159971,37
95,1990,89,106,133,110.106617500066,44
95,1991,104,118,136,120.160516095082,32
95,1992,88,107,132,110.371601100026,44
95,1993,93,113,146,122.376167129742,53
95,1994,96,114,128,116.41301530988,32
95,1995,90,112,121,112.709046455042,31
95,1996,101,116,137,121.872964169717,36
95,1997,98,116,138,122.576584416373,40
95,1998,94,115,138,118.12364448945,44
95,1999,99,114,141,121.928825565302,42
95,2000,97,113,134,119.288225217388,37
95,2001,100,114,142,120.94699708631,42
95,2002,99,123,149,127.221798155955,50
95,2003,97,115,134,116.403483408716,37
95,2004,99,114,135,119.104430354565,36
95,2005,98,124,143,124.27777778273,45
95,2006,92,109,123,112.880829001903,31
95,2007,89,119,144,119.691544717668,55
95,2008,95,114,137,117.729585525072,42
95,2009,92,114,135,119.07187985855,43
95,2011,81,106,141,114.762571206569,60
95,2013,99,123,142,124.198069228356,43
95,2014,85,107,129,112.754031884606,44
95,2015,86,116,134,116.815498528526,48
96,1979,97,111,114,110.172641360539,17
96,1980,74,111,144,112.684136464976,70
96,1981,103,115,146,125.163169338729,43
96,1982,88,114,130,114.776892430187,42
96,1983,97,109,132,115.263456873246,35
96,1984,84,106,127,110.194942063176,43
96,1985,104,123,137,124.558217026703,33
96,1986,102,126,151,128.873346415182,49
96,1987,74,104,126,103.549058666199,52
96,1988,116,128,138,130.04047429415,22
96,1989,81,102,125,104.392748575711,44
96,1990,94,111,131,115.587921852007,37
96,1991,98,117,138,120.96588772076,40
96,1992,86,106,134,112.134608766567,48
96,1994,94,110,137,117.051075490578,43
96,1995,90,102,139,111.928792180171,49
96,1996,103,113,139,117.709321039837,36
96,1998,102,111,131,116.288484136188,29
96,1999,97,103,115,108.339778898355,18
96,2000,97,116,137,118.034328989558,40
96,2009,93,106,136,115.833315128446,43
96,2011,88,109,130,114.069766477551,42
96,2015,94,116,130,116.984226102406,36
97,1979,101,126,157,127.674239055971,56
97,1980,96,143,167,136.853224879509,71
97,1981,100,134,156,133.313605637155,56
97,1982,91,123,148,121.339550903138,57
97,1983,97,117,141,121.736447857747,44
97,1984,101,128,155,128.437618900983,54
97,1985,99,121,158,127.005117339407,59
97,1986,97,127,157,130.783500945554,60
97,1987,96,116,152,124.04798801882,56
97,1988,91,129,159,128.315155972759,68
97,1989,91,126,144,125.14231945369,53
97,1990,106,130,153,131.803374134841,47
97,1991,117,136,166,144.619155958309,49
97,1992,102,128,150,133.534172656217,48
97,1993,95,135,165,137.720064365051,70
97,1994,105,130,142,130.761076036288,37
97,1995,98,128,152,127.634059530315,54
97,1996,109,138,156,138.939191696269,47
97,1997,111,135,161,137.105586284169,50
97,1998,130,141,159,145.916100475282,29
97,1999,110,128,155,135.32325776522,45
97,2000,109,138,157,139.432755140725,48
97,2001,74,116,151,117.247414277055,77
97,2002,113,135,155,139.984543846797,42
97,2003,106,127,153,131.189606170958,47
97,2004,110,130,154,135.215121077343,44
97,2005,102,124,151,128.191858057238,49
97,2006,95,122,157,129.26007898765,62
97,2007,102,139,168,139.958289552978,66
97,2008,102,133,161,135.10687935993,59
97,2009,90,125,150,124.586105167392,60
97,2011,88,124,152,128.228759724004,64
97,2013,103,137,157,137.306561714242,54
97,2014,81,116,146,118.228152450851,65
97,2015,85,116,150,122.455758929722,65
98,1980,88,112,137,113.545644747655,49
98,1981,104,117,145,123.208011308299,41
98,1982,90,102,123,108.939565932203,33
99,1980,114,132,149,134.719749736382,35
99,1981,93,106,127,114.566022600186,34
99,1982,91,110,130,112.417158693065,39
99,1983,103,117,129,117.911665625926,26
99,1984,97,116,140,120.478666794521,43
99,1985,102,130,151,131.542894960283,49
99,1986,95,112,133,117.495435193496,38
99,1987,97,119,140,122.4216571366,43
99,1988,104,118,140,122.528158356016,36
99,1989,87,108,123,109.772052761062,36
99,1990,90,109,130,114.750490442819,40
99,1991,104,117,139,125.215192571631,35
99,1992,90,111,132,113.457358564924,42
99,1993,96,110,133,114.794825615877,37
99,1994,95,111,131,114.047949377319,36
99,1995,96,111,126,115.031541977287,30
99,1996,103,117,138,121.807076321842,35
99,1997,96,112,130,116.074884833626,34
99,1998,95,110,131,115.926702626238,36
99,1999,86,103,123,107.426306598674,37
99,2000,89,116,134,115.378323966828,45
99,2001,93,106,130,112.621323132477,37
99,2002,85,108,132,111.63023090675,47
99,2004,89,109,120,111.341646154806,31
99,2005,89,100,132,110.486697198199,43
99,2006,90,100,120,106.987149124507,30
99,2007,89,109,127,110.897561041295,38
100,1981,101,120,145,124.708072865474,44
100,1982,90,106,121,109.547148263071,31
100,1983,102,107,127,115.324658508311,25
100,1984,89,103,130,109.78493469938,41
100,1985,92,114,130,117.43068705219,38
100,1986,92,106,130,115.816327146728,38
100,1987,99,109,128,116.157582745721,29
100,1988,81,105,118,105.256670435291,37
100,1989,80,101,123,106.525976224001,43
100,1990,89,107,121,111.101284389992,32
100,1991,97,106,129,112.409023247879,32
100,1992,86,105,113,104.41903543307,27
100,1993,83,100,133,105.105609839054,50
100,1994,91,111,120,111.423359648319,29
100,1995,88,110,123,110.240116540907,35
100,1996,94,110,120,113.967201035394,26
100,1997,105,116,122,118.966952718471,17
100,1998,90,108,120,112.066520786435,30
100,1999,98,111,131,114.430182969491,33
100,2000,87,102,115,106.552016661246,28
100,2001,103,116,136,120.875514004619,33
100,2002,96,110,138,117.739143185276,42
100,2003,85,105,120,107.462495650927,35
100,2004,83,104,123,105.428535338123,40
100,2005,90,110,131,110.940763785055,41
100,2006,79,104,115,102.275670172776,36
100,2007,72,100,120,102.731673718811,48
101,1981,101,120,139,123.983689481385,38
101,1982,103,115,131,121.312217187896,28
101,1983,112,116,128,122.599917244549,16
101,1984,101,114,127,116.439871139797,26
101,1985,116,130,151,136.015399763989,35
101,1986,102,115,133,118.54552195232,31
101,1987,109,127,141,127.429786389225,32
101,1988,95,110,133,117.264990564508,38
101,1989,96,110,124,112.650550087996,28
101,1990,103,119,130,120.048016202755,27
101,1991,102,118,135,122.802159840635,33
101,1992,88,109,128,111.244425942039,40
101,1993,116,123,139,129.085502279641,23
101,1994,102,115,130,121.014650704961,28
101,1995,100,116,129,118.069018799113,29
101,1996,105,123,142,126.299464860556,37
101,1997,107,123,134,124.166372794148,27
101,1998,112,123,146,129.048671149024,34
101,1999,104,114,130,119.40595447647,26
101,2000,108,130,143,130.076619871485,35
101,2002,109,120,134,125.669481607389,25
101,2003,95,107,126,113.451672027017,31
101,2004,104,126,136,125.976995624917,32
101,2005,94,109,127,112.755004292815,33
101,2006,96,117,129,115.581532366085,33
101,2007,100,121,134,124.312114923693,34
101,2008,104,113,137,121.467573889085,33
101,2009,85,110,129,111.401448866769,44
101,2011,95,118,128,117.250231089808,33
101,2013,100,115,122,115.94436505592,22
101,2014,86,102,121,109.200967987066,35
101,2015,102,116,135,122.264277102526,33
102,1981,88,108,144,114.632882152016,56
102,1982,78,96,116,100.204997828607,38
102,1983,93,107,127,111.126246116347,34
102,1984,87,99,113,101.977267873555,26
102,1985,93,109,123,111.869385480528,30
102,1986,92,106,130,114.118095565729,38
102,1987,91,102,127,110.289673794941,36
102,1988,86,105,128,111.0783678802,42
102,1989,77,94,111,97.9672001947914,34
102,1990,83,95,123,101.068572756198,40
102,1991,97,111,130,116.536601008776,33
102,1992,81,97,116,99.6615810413115,35
102,1993,80,94,123,103.278371823811,43
102,1994,87,100,129,108.398948205522,42
102,1995,88,99,127,105.61613259348,39
102,1996,85,105,125,112.038230369447,40
102,1997,79,102,118,105.93277295283,39
102,1998,83,102,130,109.190328140424,47
102,1999,87,101,129,107.666258626528,42
102,2000,88,107,127,110.697742271909,39
102,2001,88,105,125,108.885130573651,37
102,2002,87,109,130,113.836990291192,43
102,2003,81,97,116,102.824571903694,35
102,2004,81,109,129,109.238640866131,48
102,2005,88,100,123,104.37196605524,35
102,2006,84,95,115,101.313216617787,31
102,2007,80,94,121,98.6575595494487,41
102,2008,88,106,120,108.637942966156,32
102,2011,72,92,126,98.5187771137823,54
102,2013,86,104,129,109.778265275223,43
102,2014,73,85,113,93.4149405823502,40
102,2015,85,101,125,105.477908410712,40
103,1981,88,124,165,127.830993820099,77
104,1981,88,112,134,114.135792692889,46
104,1982,88,108,131,112.172464095003,43
104,1983,96,108,120,112.934035868779,24
104,1984,96,115,135,116.664940600406,39
104,1985,112,123,143,127.64266750663,31
104,1986,104,116,142,121.860380335653,38
104,1987,89,106,137,113.457943100899,48
104,1988,93,107,141,116.738146553763,48
104,1989,86,99,113,103.508365509484,27
104,1990,88,105,116,106.17733874414,28
104,1991,102,119,140,125.396214522955,38
104,1992,98,112,128,116.459171486668,30
104,1993,89,109,129,111.1111726765,40
104,1994,97,105,121,108.563384503596,24
104,1995,82,100,122,104.913365399877,40
104,1996,94,111,126,111.70659924393,32
104,1997,88,112,135,112.359109041582,47
104,1998,89,113,140,116.832046447794,51
104,1999,89,110,133,113.063692913224,44
104,2000,86,102,128,109.009307760495,42
104,2001,94,114,132,115.005837321137,38
104,2002,78,108,132,111.952376725948,54
104,2003,74,97,117,98.1708624782452,43
104,2004,88,102,129,110.853559071761,41
104,2005,87,108,147,114.073162585267,60
104,2006,85,108,121,106.824711972026,36
104,2007,80,100,123,105.483486527911,43
104,2013,109,123,137,127.49565732465,28
104,2014,73,93,113,99.3432014203202,40
104,2015,81,101,121,103.121044469185,40
106,1982,93,109,122,111.060641373371,29
106,1983,94,107,121,110.130679405064,27
106,1984,96,113,128,115.332986654923,32
106,1985,99,114,128,117.670745338192,29
106,1986,92,116,127,115.977204390415,35
106,1987,97,106,132,114.875165437501,35
106,1988,91,110,127,114.545350349991,36
106,1989,86,101,123,106.587654336654,37
106,1990,85,102,120,105.986581210714,35
106,1991,101,114,134,119.840990881569,33
106,1992,86,100,125,107.755600018169,39
106,1993,85,99,124,106.661996313285,39
106,1994,92,106,128,113.478225743406,36
106,1995,95,110,127,112.43287366393,32
106,1996,100,113,134,117.749989469812,34
106,1997,93,116,134,118.328947381011,41
106,1998,99,113,137,120.47764410672,38
106,1999,97,110,121,111.602166304921,24
106,2000,93,122,136,121.322177465473,43
106,2001,93,107,127,113.754472295279,34
106,2002,95,115,136,116.708472991525,41
106,2003,85,106,127,111.470866043139,42
106,2004,102,120,136,119.632810731027,34
106,2005,92,106,128,114.030377289523,36
106,2006,90,108,134,114.528304699016,44
106,2007,94,113,135,116.564265689139,41
106,2008,92,113,137,116.283968703335,45
106,2009,85,107,127,111.52540180499,42
106,2011,92,116,135,118.530303038665,43
106,2013,108,123,141,128.930380503498,33
106,2014,86,116,127,112.697559498355,41
106,2015,100,123,128,120.576975532574,28
107,1982,90,99,120,106.434782486259,30
107,1983,93,106,125,109.39285714473,32
107,1984,92,108,113,107.498039033199,21
107,1985,99,123,139,124.185444121719,40
107,1986,104,115,127,118.679686408285,23
107,1987,96,103,128,111.797402700413,32
107,1988,104,118,137,120.916114955669,33
107,1989,86,95,106,100.623907565236,20
107,1990,86,103,112,104.562609857257,26
107,1991,92,118,130,117.746839557281,38
107,1992,81,97,122,104.19654426292,41
107,1993,86,105,113,106.141731868652,27
107,1994,85,101,120,107.837597411527,35
107,1995,89,111,120,109.155769523097,31
107,1996,86,111,131,111.916956573664,45
107,1997,92,110,129,113.18345305527,37
107,1998,96,107,124,110.91432027167,28
107,1999,86,100,124,107.770555512189,38
107,2000,93,106,120,110.466151603393,27
107,2001,92,114,127,115.50510905725,35
107,2002,95,106,120,111.542781082011,25
107,2003,92,99,118,105.847058810538,26
107,2004,81,108,122,108.060355200423,41
107,2005,94,101,123,108.129447309155,29
108,1982,82,107,132,108.365562693531,50
108,1983,83,106,132,110.935896156268,49
108,1984,94,114,143,118.773195875943,49
108,1985,93,106,132,114.006407812269,39
108,1986,88,119,134,116.287195332276,46
108,1987,96,107,143,118.782203889716,47
108,1988,90,118,138,117.357615909724,48
108,1989,73,96,120,100.021324785451,47
108,1990,85,103,122,105.735999840758,37
108,1991,108,128,141,130.270408986206,33
108,1992,83,95,122,104.108361255538,39
108,1993,91,109,130,112.895326391707,39
109,1982,81,104,123,106.120942116439,42
110,1983,101,107,125,114.099644659672,24
110,1984,81,92,121,103.292054686626,40
110,1985,87,107,151,115.752283300621,64
110,1986,97,111,146,117.312043203346,49
110,1987,86,103,131,111.404046042715,45
110,1988,83,102,124,106.05415726697,41
110,1989,73,89,106,95.8059361522793,33
110,1990,71,94,124,98.3071639741262,53
110,1991,89,117,135,118.412413624937,46
110,1992,82,97,120,102.617977968586,38
110,1993,84,97,123,105.002470174573,39
111,1983,92,98,117,104.049722901042,25
111,1984,96,111,130,113.958710360808,34
111,1985,93,104,118,109.024566702129,25
111,1986,86,107,127,111.206075024716,41
111,1987,95,109,129,113.566872951288,34
111,1988,80,95,122,103.431307934715,42
111,1989,78,94,113,97.3775100390571,35
111,1990,79,88,115,95.5510005273109,36
111,1991,101,111,128,115.78799946814,27
111,1992,72,90,107,97.7669984643772,35
111,1993,76,94,113,101.408643372759,37
111,1994,88,102,125,107.57931513626,37
111,1995,89,112,124,112.752044972471,35
111,1996,93,108,113,109.981126657547,20
111,1997,65,93,125,99.7366695811754,60
111,1998,59,105,144,107.982103153495,85
111,1999,75,101,130,108.097269531587,55
111,2000,93,108,129,113.978461302825,36
111,2001,86,104,114,107.062766600877,28
111,2002,95,107,123,112.305638213251,28
111,2003,73,87,118,97.4590643275159,45
111,2004,89,106,124,109.481890190704,35
111,2005,81,92,116,99.3064091059935,35
111,2006,81,102,116,102.227461105108,35
111,2007,81,101,121,108.111788452425,40
111,2008,88,105,126,108.667723293151,38
111,2009,83,92,107,96.9098768203832,24
111,2011,88,102,116,105.461174063077,28
111,2013,95,108,136,117.401548927303,41
111,2014,80,93,114,98.5719854717939,34
111,2015,85,97,121,103.255190436073,36
112,1980,87,114,137,116.255886230191,50
112,1981,98,118,144,119.502739665679,46
112,1982,81,102,130,106.555138883442,49
112,1983,94,101,130,109.693555554721,36
112,1984,86,93,114,101.081136288064,28
112,1985,91,109,137,114.85748511133,46
112,1986,97,106,123,115.113503786771,26
112,1987,90,115,142,119.103916124167,52
112,1988,84,95,130,104.091473691991,46
112,1989,79,109,126,106.3368078816,47
112,1990,75,93,125,99.310126563427,50
112,1991,81,107,134,111.687344695988,53
112,1992,81,112,137,111.004192001075,56
112,1993,81,109,137,112.918486990701,56
112,1994,89,109,130,111.78318657021,41
112,1995,83,99,131,106.175469915973,48
112,1996,88,105,134,115.088597255099,46
112,1997,77,109,135,109.470588235294,58
112,1998,86,105,131,110.672584152056,45
112,1999,74,114,149,116.691483647688,75
112,2000,87,106,133,112.186992811813,46
112,2001,81,106,130,110.605698732848,49
112,2002,85,104,142,113.137941370022,57
112,2003,67,100,144,107.077552782012,77
112,2004,72,102,129,104.126345589091,57
112,2005,83,98,130,103.60880171038,47
112,2006,83,105,123,106.340441016353,40
112,2007,68,109,157,115.723436167413,89
112,2008,36,95,144,96.5129560128832,108
112,2013,60,109,148,110.412951054222,88
112,2014,81,95,109,95.9762418140882,28
112,2015,53,101,144,102.718061498755,91
113,1983,95,111,130,114.974293404389,35
113,1984,99,114,127,120.747958564711,28
113,1985,99,114,130,121.066342869683,31
113,1986,92,119,138,119.675636173622,46
113,1987,109,121,137,126.824079298968,28
113,1988,98,116,135,121.859038307632,37
113,1989,87,102,119,107.523331414715,32
113,1990,90,102,120,105.842660971896,30
113,1991,100,112,128,117.457238150105,28
113,1992,83,102,120,105.308394950557,37
113,1993,84,102,130,108.102750988043,46
113,1994,93,107,128,112.560673106316,35
113,1995,88,100,120,108.421584372903,32
113,1996,101,113,137,118.896512011366,36
113,1997,89,106,124,110.028883220873,35
113,1998,95,116,134,118.047961053784,39
113,1999,87,108,120,108.525486971394,33
113,2000,88,109,130,111.889692939257,42
113,2001,86,115,136,115.207432007804,50
113,2002,85,109,127,109.553339313049,42
113,2003,73,100,139,108.243611822925,66
113,2004,88,109,120,109.731417101723,32
113,2005,83,101,131,108.537950047879,48
113,2006,89,109,137,112.698883449365,48
113,2007,80,95,126,101.698016381778,46
113,2008,85,101,120,107.63968393933,35
113,2009,84,95,123,102.385453645421,39
113,2011,75,93,122,98.1818392945318,47
113,2013,88,106,133,113.044680895949,45
113,2014,78,107,127,109.017188645195,49
113,2015,86,100,120,104.995110782561,34
114,1985,99,114,131,119.652099088454,32
114,1986,94,110,123,113.684835644642,29
114,1987,93,117,140,120.822679797168,47
114,1988,91,111,129,114.58750000988,38
114,1989,81,101,115,101.818309609075,34
114,1990,83,103,117,103.72213181825,34
114,1991,101,117,135,121.212062082203,34
114,1992,83,98,120,104.381035997373,37
114,1993,86,103,123,104.844961251746,37
114,1994,85,107,120,107.599422245844,35
114,1995,116,116,123,122.90778561208,7
114,1997,85,112,140,116.940315653301,55
115,1986,93,113,127,114.707046762811,34
115,1987,95,109,123,112.093008157702,28
115,1988,102,120,128,119.599332608853,26
115,1989,80,95,118,102.415628548114,38
115,1990,83,102,119,103.161397147725,36
115,1991,101,113,135,120.012822699006,34
115,1992,82,103,121,106.133162345954,39
115,1993,81,105,121,103.532259960081,40
115,1994,90,108,123,109.196021962386,33
115,1995,87,100,110,104.6063190061,23
115,1996,93,107,127,114.04862937807,34
115,1997,78,101,127,105.783783137364,49
115,1998,85,106,128,110.928311623101,43
115,1999,89,99,120,105.454873343148,31
115,2000,79,102,120,106.856945312954,41
115,2001,85,103,121,106.100041604948,36
115,2002,85,101,124,104.748024539437,39
115,2003,81,100,121,102.890346552702,40
115,2004,75,96,122,102.514930019717,47
115,2005,88,106,124,107.019687952209,36
115,2006,89,101,124,104.30152944406,35
115,2007,89,110,121,108.427411314795,32
115,2008,89,104,121,106.854597030653,32
115,2009,78,92,115,100.681208592519,37
115,2011,86,92,123,103.709156919831,37
115,2013,98,116,144,121.868878718595,46
116,1985,104,113,127,116.324365639139,23
116,1986,99,120,141,125.607224162876,42
116,1987,105,107,120,112.709936889656,15
116,1988,71,102,138,107.125315223508,67
116,1989,75,102,135,107.811512376952,60
116,1990,93,108,122,110.927970228134,29
116,1991,95,115,127,115.462834913326,32
116,1992,90,111,123,111.277884261312,33
116,1993,103,113,127,118.139203630273,24
116,1994,88,126,153,123.136917395293,65
116,1995,94,116,138,119.937900193141,44
116,1996,107,115,145,123.250084356205,38
116,1997,85,113,141,115.480361831332,56
116,1998,86,106,123,110.009507612439,37
116,1999,78,109,138,112.64629343805,60
116,2000,92,107,130,113.830027946908,38
116,2001,85,104,122,106.997227534128,37
116,2002,101,108,123,112.666286173386,22
116,2003,93,106,126,112.421955271687,33
116,2004,98,116,127,115.809428947976,29
116,2005,101,123,136,122.44275547913,35
116,2006,104,115,129,118.844665186545,25
116,2007,88,110,132,110.369867476672,44
116,2008,95,115,127,117.976966739234,32
116,2009,93,113,127,113.915766365022,34
116,2011,120,120,127,126.999999999662,7
116,2013,87,124,158,126.689276177474,71
116,2014,81,109,130,110.172431468712,49
116,2015,72,109,144,113.668510689835,72
117,1986,93,106,127,111.032526838117,34
117,1987,98,109,122,113.079463851677,24
117,1988,88,109,127,111.579074219602,39
117,1989,80,95,110,98.9980638058344,30
117,1990,81,94,119,100.797734184474,38
117,1991,102,113,129,118.424542876924,27
117,1992,82,105,121,104.960984322417,39
117,1993,78,99,113,102.839599774105,35
117,1994,85,106,121,107.779739674306,36
117,1995,89,99,113,105.232064282509,24
117,1996,92,106,127,113.733114656114,35
117,1997,78,99,127,103.568493158546,49
117,1998,86,101,120,105.009799841144,34
117,1999,84,93,115,99.5464510208434,31
117,2000,79,99,120,104.601295864568,41
117,2001,85,104,114,105.814610107395,29
117,2002,85,101,122,107.296466968679,37
117,2003,81,95,115,97.7313556838424,34
117,2004,83,101,121,103.122542097173,38
117,2005,87,102,113,103.610599079293,26
117,2006,81,92,116,98.5112285322601,35
117,2007,74,95,113,96.9117646958662,39
117,2008,85,106,128,108.911656676186,43
117,2009,82,101,122,101.755905498168,40
117,2011,81,105,121,105.599136901167,40
117,2013,96,106,128,111.225130890397,32
117,2014,81,93,113,99.7387726054877,32
117,2015,86,107,128,109.738056014474,42
118,1986,92,106,127,114.261054952552,35
118,1987,94,115,129,116.23925136701,35
118,1988,91,112,125,111.439655162319,34
118,1989,80,94,116,100.965023847765,36
118,1990,90,103,123,105.815303423424,33
118,1991,101,122,143,124.046571979521,42
118,1992,84,102,120,103.820680481004,36
118,1993,84,102,128,108.390413091258,44
118,1994,89,103,123,108.085343965689,34
118,1995,74,101,136,106.610066577142,62
118,1996,97,113,130,117.258134259845,33
118,1997,79,99,124,105.797735360862,45
118,1998,88,109,128,111.311818115152,40
118,1999,91,100,120,106.795047182761,29
118,2000,88,110,133,112.506867552979,45
118,2003,86,105,115,104.654493668996,29
118,2004,88,109,130,112.800177369594,42
118,2005,88,105,133,107.73223057841,45
118,2006,81,95,116,101.321518758224,35
118,2007,74,102,121,102.727034726801,47
119,1987,96,109,136,115.372439064052,40
119,1988,88,109,138,116.489405737503,50
119,1989,88,104,137,111.297494324565,49
119,1990,88,110,145,115.395350363829,57
119,1991,101,131,144,129.068477572157,43
119,1992,84,102,120,105.991710594361,36
119,1995,88,112,122,111.56800814466,34
119,1996,95,113,137,117.334666801322,42
119,1997,88,112,134,115.918489756741,46
119,1998,94,116,136,119.362737392468,42
119,1999,84,100,131,109.185662748296,47
119,2000,88,110,137,114.526468290888,49
119,2001,94,114,130,115.104764095153,36
119,2002,95,120,144,121.568513730983,49
119,2003,81,112,130,111.173689292394,49
119,2004,88,118,137,118.379651455982,49
119,2005,85,112,130,113.409006084975,45
119,2006,89,109,130,112.056792383223,41
119,2007,67,110,151,114.364068926132,84
119,2008,91,107,137,114.507405033761,46
119,2009,83,104,137,105.660910731117,54
119,2011,88,109,138,113.215172003122,50
119,2013,106,123,149,127.572575992319,43
119,2014,84,102,137,110.086546762911,53
119,2015,88,123,150,124.818543816889,62
120,1987,97,116,128,117.140775807009,31
120,1992,86,102,121,105.295452215778,35
120,1993,90,103,121,107.831919379156,31
120,1994,102,113,130,116.652395713323,28
120,1995,97,110,115,109.604502378541,18
120,1996,97,113,129,118.448698390726,32
120,1997,96,106,129,114.548670757692,33
120,1998,80,105,121,105.63521860071,41
120,1999,89,97,118,104.819958212413,29
120,2000,60,95,138,102.520825526796,78
121,1987,93,109,120,110.880795292248,27
121,1988,83,92,116,102.155363901607,33
122,1987,94,99,115,107.55479378883,21
122,1988,80,100,127,104.48148147422,47
122,1989,79,94,113,99.0922495339713,34
122,1990,71,93,114,97.1693548573381,43
122,1991,93,113,127,114.725099600728,34
122,1992,81,95,113,99.1982758613608,32
122,1993,85,92,116,101.219809751839,31
122,1994,85,100,120,106.02519167553,35
122,1995,87,107,120,107.770293610429,33
122,1996,92,106,128,111.973356276749,36
122,1997,78,99,127,104.462006782223,49
122,1998,85,110,128,110.6534090836,43
122,1999,87,106,120,107.922432723158,33
122,2000,86,108,127,113.407758620717,41
122,2001,86,106,122,108.305120527449,36
122,2002,85,113,128,112.4579544497,43
122,2003,78,99,121,104.899020280811,43
122,2004,88,104,125,109.321093040661,37
122,2005,80,101,113,102.373581847584,33
122,2006,85,102,117,105.325432261461,32
122,2007,74,94,113,97.4442571630112,39
122,2008,80,99,121,104.108496476332,41
122,2009,80,92,113,97.6330390909316,33
122,2011,67,85,120,94.6053097193175,53
123,1988,53,98,144,101.849486003442,91
123,1996,99,108,123,112.781697153165,24
123,1997,95,111,126,110.159311099733,31
123,1998,79,116,151,119.014245205178,72
123,1999,74,102,119,101.60882355199,45
123,2000,67,107,152,110.991647155829,85
123,2001,106,113,123,120.132936118952,17
123,2002,95,109,123,111.154437728901,28
123,2003,65,97,128,101.25135302365,63
124,1989,83,93,117,99.0386942190248,34
124,1990,82,104,124,107.919873819724,42
124,1991,92,116,135,117.814057408338,43
124,1992,79,104,115,105.162854372858,36
124,1993,66,110,158,112.928658505089,92
124,1994,98,111,127,116.586374710839,29
124,1995,67,102,137,106.75283053022,70
124,1996,73,100,130,106.075941400763,57
124,1997,88,109,130,114.662783064683,42
124,1998,109,109,116,114.946021151539,7
124,1999,95,113,128,113.598559125959,33
124,2000,88,108,133,115.065128905939,45
124,2001,77,116,150,119.745839046013,73
124,2002,101,117,127,116.388574051537,26
124,2003,86,100,114,104.948038646394,28
124,2004,96,111,127,114.149080280754,31
124,2005,92,106,130,112.035606525705,38
124,2006,90,102,123,108.898335021999,33
124,2007,87,100,122,105.949999994762,35
124,2008,92,102,109,108.106480391314,17
124,2009,90,101,121,106.842879524484,31
124,2013,101,118,121,117.090839838313,20
124,2014,81,93,117,102.8386509776,36
124,2015,94,109,121,112.395941869835,27
125,1989,88,121,141,119.705104500384,53
125,1990,106,127,149,128.530019601671,43
125,1991,118,141,155,140.097161724473,37
125,1992,109,130,158,134.172582141349,49
125,1993,102,135,155,133.699052828757,53
125,1994,101,121,149,125.777700587157,48
125,1995,94,121,134,121.761606748464,40
125,1996,116,135,155,137.393207152905,39
126,1989,84,102,142,110.584455143375,58
126,1990,102,120,134,121.182454759867,32
126,1991,112,128,148,130.153491156919,36
126,1992,86,113,137,115.598318499065,51
126,1993,94,128,150,126.04067947199,56
126,1994,92,113,131,115.498225194483,39
126,1995,96,113,134,119.940689509357,38
126,1997,88,120,141,120.292343514939,53
126,1998,105,127,153,130.221772076482,48
126,1999,100,121,144,125.63951148098,44
126,2000,93,122,141,125.285967588506,48
126,2005,101,124,150,126.970996137193,49
126,2006,103,127,161,131.951099972821,58
127,1989,88,109,121,108.590110799596,33
127,1991,127,127,134,133.999999999906,7
127,1992,81,88,88,88.3708511470383,7
127,2001,109,116,123,121.411601017121,14
127,2009,116,123,130,124.741752458045,14
127,2011,130,137,144,143.401150613875,14
128,1989,93,102,123,108.072727276317,30
128,1990,94,115,136,117.833326214108,42
128,1991,101,113,135,119.264147388756,34
128,1992,85,99,122,105.418145952906,37
128,1993,96,116,131,117.570743404689,35
128,1994,107,120,135,122.627070170115,28
128,1995,94,110,125,114.445106660797,31
128,1996,106,126,134,124.849442368241,28
128,1997,96,111,120,114.015153526072,24
128,1998,93,116,137,119.001253910041,44
128,1999,100,110,120,113.776119398254,20
128,2000,92,113,127,116.736583952113,35
128,2002,102,117,134,121.436692088252,32
128,2003,86,106,125,110.512123076218,39
128,2004,86,110,128,113.530172412415,42
128,2005,98,113,130,115.948024943556,32
128,2006,94,108,120,111.897443563055,26
128,2008,95,117,130,116.757747000971,35
128,2009,87,102,130,109.706623444524,43
128,2014,46,88,120,87.502712779799,74
128,2015,102,121,139,123.01097879449,37
129,1989,80,108,139,110.883979264781,59
129,1990,93,114,144,120.625641023392,51
129,1991,111,137,149,135.837757527093,38
129,1992,89,123,143,124.009718086322,54
129,1993,93,128,150,127.529493732712,57
129,1994,102,123,142,124.898013841849,40
129,1995,82,112,132,111.919764374431,50
129,1996,105,121,141,124.55656555449,36
129,1997,97,131,141,126.876360544429,44
129,1998,95,130,165,135.052138604414,70
129,1999,88,116,152,122.417014895032,64
129,2000,90,123,144,122.526226975084,54
129,2002,109,137,156,136.552143535531,47
129,2003,100,126,144,125.263430396757,44
129,2004,102,126,144,128.823921356022,42
129,2005,95,125,151,128.42624679965,56
129,2006,94,115,152,122.528682172347,58
129,2007,119,137,157,140.207235067748,38
129,2008,92,130,151,127.417882455753,59
129,2009,80,133,161,125.855136900486,81
129,2011,92,130,158,128.933918570364,66
129,2013,99,128,156,129.979148529405,57
129,2014,88,115,137,115.202733254736,49
129,2015,86,114,143,118.187169566372,57
130,1989,80,94,108,96.3609195439287,28
130,1990,78,99,113,101.023689084453,35
130,1991,97,112,131,117.199332131175,34
130,1992,82,103,122,102.337312325765,40
130,1993,90,99,114,104.772741445754,24
130,1994,83,105,126,107.184453630427,43
130,1995,86,101,113,106.143474001532,27
130,1996,93,109,123,112.778127792612,30
130,1997,78,102,120,106.476328622387,42
130,1998,82,100,116,103.972668399677,34
130,1999,86,105,123,106.782757650382,37
130,2000,86,110,126,110.579787220788,40
130,2001,102,119,137,121.995397410497,35
130,2002,105,116,136,120.393193177408,31
130,2003,84,101,126,107.311873984477,42
130,2004,72,108,144,112.495814306908,72
130,2005,83,103,129,107.48496665296,46
130,2007,102,123,144,126.436813448035,42
130,2011,52,87,130,94.7581737327008,78
130,2013,88,104,115,108.230492363881,27
130,2014,78,93,107,95.6603420801461,29
130,2015,85,95,100,96.0408378411483,15
131,1989,81,112,140,114.866878939726,59
131,1990,98,111,133,114.934661051215,35
131,1991,108,138,162,139.149297526556,54
131,1992,79,115,129,114.390900941063,50
131,1993,98,114,158,122.530463788586,60
131,1994,39,81,116,82.9029375949632,77
131,1996,96,120,141,122.115921197635,45
131,1997,54,106,152,104.807469918757,98
132,1989,81,102,113,100.949420271838,32
132,1990,88,103,123,106.207662673787,35
132,1991,108,120,141,125.223083898623,33
132,1992,86,107,120,109.48179349203,34
132,1993,88,99,123,106.584564516331,35
132,1994,92,111,128,114.527525116695,36
132,1995,95,110,132,113.043197131759,37
132,1996,100,113,130,118.087522822875,30
132,1998,99,115,135,118.67190339232,36
132,1999,86,107,128,111.60774822324,42
132,2000,94,117,129,115.77379808655,35
132,2001,92,113,136,116.618879738287,44
133,1989,71,95,114,98.9091844851851,43
133,1990,77,102,126,103.882611369338,49
133,1991,97,116,139,120.856012457727,42
133,1993,88,108,128,112.035200776859,40
133,1994,92,107,128,112.009827506844,36
133,1995,82,107,127,109.248655404554,45
133,1996,97,116,135,118.438906507076,38
133,1997,96,99,137,111.776637009358,41
133,1998,89,109,134,115.700644049568,45
133,1999,91,114,137,119.797847863126,46
133,2000,86,109,137,114.561947991054,51
133,2001,83,106,139,109.625651107989,56
133,2002,94,115,146,122.746806175966,52
133,2003,85,107,127,113.318376710794,42
133,2004,80,122,143,119.80699062563,63
133,2005,95,113,142,121.631029886684,47
133,2006,90,113,134,115.275550506099,44
133,2007,90,120,148,121.568750748827,58
133,2008,85,116,144,120.099527113717,59
133,2009,75,105,134,110.318749999998,59
133,2011,82,101,137,109.339762465978,55
133,2013,96,114,134,117.039104685926,38
133,2014,81,101,129,107.080490921907,48
133,2015,85,107,128,114.761930618692,43
134,1989,88,102,123,106.400599148345,35
134,1990,88,104,124,108.417641680675,36
134,1991,102,117,147,123.03146476453,45
134,1992,85,108,139,115.537511264246,54
134,1993,92,109,128,113.536622236482,36
134,1994,103,113,134,117.937938827683,31
134,1995,87,103,122,110.49311023347,35
134,1996,101,123,143,126.334777407031,42
134,1997,100,130,149,130.026504386619,49
134,1998,98,115,148,123.161414665355,50
134,1999,99,120,154,129.131620884168,55
134,2000,95,117,140,120.011634951142,45
134,2001,110,122,146,128.341103051374,36
134,2002,107,130,149,134.157172094115,42
134,2003,100,115,134,118.8784394018,34
134,2004,86,107,131,110.437671425388,45
134,2005,94,110,145,114.874168451652,51
134,2006,90,109,136,116.320588767443,46
134,2007,81,109,137,112.682564083084,56
134,2008,99,123,151,129.264943765832,52
134,2009,113,123,137,129.65377318666,24
134,2013,104,118,143,126.133957275485,39
134,2014,74,117,158,119.467684013755,84
134,2015,91,107,130,112.619466743061,39
135,1989,86,104,122,106.845641272302,36
135,1990,80,104,117,105.468776522093,37
135,1991,95,114,134,119.170060217959,39
135,1992,86,109,121,108.78753261313,35
135,1993,81,98,122,105.626692888989,41
135,1994,97,108,128,113.342699403741,31
135,1995,87,101,116,108.752626695626,29
135,1996,92,109,127,112.575234520809,35
135,1997,84,112,120,108.121657285677,36
135,1998,94,107,125,110.735652463666,31
135,1999,85,99,114,104.350784050952,29
135,2000,87,116,138,116.277253029448,51
135,2001,93,108,121,109.773482456215,28
135,2002,86,102,127,109.30110911823,41
135,2003,85,101,126,106.677585622641,41
135,2004,90,110,120,111.518785293645,30
135,2005,81,103,124,104.914738117151,43
135,2007,88,109,121,110.533456020139,33
135,2008,92,106,128,113.423668214451,36
135,2009,77,95,120,100.178845475117,43
135,2011,74,88,115,97.1161653335597,41
135,2015,86,102,113,105.1175225846,27
136,1991,101,108,131,116.282622165048,30
136,1992,78,101,121,102.720129767809,43
136,1993,89,102,116,104.675072302281,27
136,1994,92,108,120,108.71217174772,28
136,1995,88,96,116,102.904325054028,28
136,1996,96,108,127,112.700695923225,31
136,1997,84,99,120,107.382556952165,36
136,1998,89,101,124,109.314059639136,35
136,1999,84,101,130,107.863465661173,46
136,2000,87,102,129,107.868849178073,42
136,2001,84,109,137,113.101801808104,53
136,2002,87,109,134,115.902317791115,47
136,2003,84,95,118,102.506692761787,34
136,2004,81,102,127,107.031985935426,46
136,2005,84,104,130,106.752321823939,46
136,2006,85,92,107,95.8541226426722,22
136,2007,60,99,148,104.116701323351,88
136,2008,84,101,128,108.561525318506,44
136,2009,84,104,134,108.749938727977,50
136,2011,81,109,137,114.484678642527,56
137,1990,95,115,130,115.258564403796,35
137,1991,92,114,134,119.579580798583,42
137,1992,87,109,128,111.092331273516,41
137,1993,82,104,138,109.900224151153,56
137,1994,88,109,131,110.975084692948,43
137,1995,81,104,120,104.848374041077,39
137,1996,88,113,131,114.722313024892,43
137,1997,88,109,136,116.576923170876,48
137,1998,97,111,125,111.781283192836,28
137,1999,90,110,128,111.185430570374,38
137,2000,97,112,123,115.542175993324,26
137,2002,95,124,134,122.776356574302,39
137,2003,88,105,113,107.293354094481,25
137,2004,69,110,151,113.331554669214,82
137,2005,84,100,109,104.224972460039,25
137,2006,81,95,109,99.6385625640617,28
138,1988,93,116,147,120.688675061405,54
138,1989,87,105,123,107.17657493391,36
138,1990,86,102,130,108.442100464262,44
138,1991,101,113,139,121.008377817761,38
138,1992,85,109,130,112.146308283416,45
139,1991,106,116,131,118.470588235216,25
139,1992,86,100,120,104.210590449728,34
139,1993,85,99,126,106.04155364596,41
139,1994,91,109,124,109.023585739266,33
139,1995,89,97,116,103.578919381106,27
139,1996,95,109,124,110.787030984601,29
139,1997,85,99,124,106.843131600554,39
139,1998,91,109,129,113.256841297397,38
139,1999,80,98,116,101.299220739219,36
139,2000,81,102,117,104.81713672951,36
139,2001,104,123,150,128.114424421431,46
139,2002,95,107,123,110.789295996525,28
139,2003,95,105,134,112.923601790667,39
139,2004,83,119,144,118.306762840401,61
139,2005,84,104,126,108.225511786046,42
139,2006,90,112,137,116.821587146217,47
139,2007,87,118,137,117.408706871692,50
139,2008,95,119,136,116.609174734779,41
139,2009,76,102,128,104.898053547544,52
139,2011,64,96,113,96.2143166981868,49
139,2013,99,124,137,122.890018571263,38
139,2014,87,105,120,107.362564800714,33
139,2015,85,100,116,103.481183796791,31
140,1991,102,116,138,122.240679136688,36
140,1992,105,118,133,120.736519130049,28
140,1993,109,128,142,130.595269529431,33
140,1994,109,127,143,128.832186491424,34
140,1995,106,118,122,117.800056280126,16
140,1996,106,120,134,123.157282763429,28
140,1997,110,114,127,120.423076927077,17
140,1998,111,124,135,125.501255660205,24
140,1999,85,117,145,119.054949615162,60
140,2000,118,124,134,128.250000000623,16
140,2001,93,115,136,119.530432300515,43
140,2002,99,118,134,122.333333333332,35
140,2003,96,106,125,111.631578940446,29
140,2004,102,117,127,119.44699135393,25
140,2005,99,116,130,117.855678487149,31
140,2006,96,106,121,111.401696578737,25
140,2007,96,106,130,113.866640228763,34
140,2008,115,125,127,126.333333335542,12
140,2011,89,112,138,113.667021889596,49
141,1991,81,103,122,103.784455107412,41
141,1992,81,112,123,108.314633370851,42
141,1993,83,116,151,119.536225977665,68
141,1995,101,130,158,132.368087567596,57
141,1996,60,102,151,106.230644881084,91
141,1997,65,99,134,103.542652310713,69
141,1998,102,111,137,119.187457715392,35
141,1999,117,120,125,121.741147305283,8
141,2000,63,102,130,100.100645963103,67
141,2001,81,102,130,109.16096670492,49
141,2002,81,113,148,118.441363466273,67
141,2003,84,102,119,102.51804569249,35
141,2004,83,116,151,116.44052064331,68
141,2005,78,109,138,109.150094482259,60
141,2006,87,106,120,106.765721188433,33
141,2007,79,95,116,99.8697417286359,37
141,2008,82,100,127,106.902648054452,45
141,2009,86,99,116,101.908174867611,30
142,1991,118,130,135,129.441893225947,17
142,1992,107,113,120,118.364579759777,13
142,1993,81,113,149,121.887273874817,68
142,1994,98,116,137,121.008750509875,39
142,1995,90,116,123,115.168259564014,33
142,1996,96,108,132,115.563008405903,36
142,1997,88,112,136,115.410171414871,48
142,1998,104,126,136,125.980593007842,32
142,1999,93,104,119,108.065056771572,26
142,2000,95,110,133,116.920756833119,38
142,2001,87,107,132,113.456937487728,45
142,2002,82,106,138,112.093590225382,56
142,2003,85,98,123,103.079736334914,38
142,2004,102,118,128,117.400331564566,26
142,2005,64,110,145,110.744168986283,81
142,2006,83,105,115,102.694029989302,32
142,2007,80,100,122,105.261131556011,42
142,2008,71,106,147,112.10216111947,76
142,2009,83,92,107,98.3251863153873,24
143,1993,110,128,142,129.759274430395,32
143,1996,96,117,145,121.941354780548,49
143,1997,100,112,130,119.284279199605,30
143,1998,94,102,126,108.90482449925,32
143,1999,85,114,151,118.957006903466,66
143,2000,75,118,158,119.830297547748,83
143,2001,115,115,123,122.999999999956,8
143,2004,88,109,120,109.080668617889,32
143,2005,95,100,124,108.896294650868,29
143,2006,99,106,115,108.975146473365,16
143,2007,93,109,130,114.607988158426,37
143,2008,100,108,130,114.092543838062,30
143,2009,91,102,122,106.840579280565,31
143,2011,95,104,123,111.004489022865,28
143,2013,98,110,115,109.437499968246,17
143,2014,92,100,109,103.199637508726,17
143,2015,102,124,135,123.051314999335,33
144,1992,90,113,135,113.922017265651,45
144,1993,68,119,153,116.906706042866,85
144,1994,106,110,133,119.781673359007,27
144,1995,95,118,130,117.280251815827,35
144,1996,95,123,151,126.732233657275,56
144,1997,95,112,137,118.408229590801,42
144,1998,107,127,148,131.202274135595,41
144,1999,96,108,121,110.914394985144,25
144,2000,103,116,130,121.428667059633,27
144,2001,93,111,115,110.336763710687,22
144,2002,107,134,149,135.653934095113,42
144,2004,96,108,124,111.34357400611,28
144,2005,95,117,123,116.855559497011,28
144,2006,89,109,117,110.358477677398,28
144,2007,79,116,153,118.833743083965,74
144,2008,95,112,130,113.395715230395,35
144,2009,61,102,144,104.772605710481,83
144,2011,94,110,131,113.563281648214,37
144,2013,103,110,124,114.811846501138,21
145,1995,93,111,138,114.950666009674,45
145,1996,102,124,141,127.1466892887,39
145,1997,96,119,146,122.773941582275,50
145,1998,100,121,151,127.700924145614,51
145,1999,93,116,137,118.188776472422,44
145,2000,88,114,141,116.049900491625,53
145,2001,93,113,148,119.632421688,55
145,2002,100,130,155,132.127899415318,55
145,2003,99,123,141,125.466110993548,42
145,2004,95,118,152,125.258072548632,57
145,2005,95,114,142,122.170042698961,47
145,2006,91,116,144,118.189076824954,53
145,2007,88,115,154,123.356565037317,66
145,2008,104,124,158,128.46315244653,54
145,2009,95,116,151,124.399604395038,56
145,2014,75,104,131,107.268171910493,56
145,2015,91,109,151,118.037296429998,60
146,1995,95,115,139,120.275050932523,44
146,1996,107,126,147,129.930535078202,40
146,1997,97,120,142,122.175547550362,45
146,1998,109,130,154,133.434735736273,45
146,1999,109,124,134,123.840480635004,25
146,2000,107,129,151,134.39942739675,44
146,2001,93,126,149,128.086651209656,56
146,2002,74,118,158,120.877865867116,84
146,2003,95,106,131,113.512934804476,36
146,2004,73,116,157,117.623430278627,84
146,2005,98,116,130,117.748915468573,32
146,2006,109,133,141,132.319011526064,32
146,2007,97,123,156,129.235974775947,59
146,2008,105,124,137,126.525309223785,32
146,2009,81,120,155,122.170544017717,74
146,2013,108,122,149,130.325468135065,41
146,2014,76,109,130,112.040182589782,54
146,2015,109,134,159,138.993696984709,50
147,1993,82,102,125,105.34335309449,43
147,1994,98,110,126,113.536491550531,28
147,1995,87,101,117,105.82178217699,30
147,1996,100,125,127,121.909082805892,27
147,1997,93,113,127,114.137528743868,34
147,1998,88,107,129,110.560958038523,41
147,1999,87,104,117,103.975101320689,30
147,2000,87,109,123,109.715334857772,36
147,2001,87,107,131,111.677256555019,44
147,2002,95,117,128,116.857977928994,33
147,2003,82,100,113,104.418131748946,31
147,2004,90,111,123,112.021567113352,33
147,2005,81,100,131,107.138327370712,50
148,1993,89,103,122,106.115491229551,33
148,1994,92,109,121,111.63752635759,29
148,1995,86,92,111,98.9226804152131,25
148,1996,97,106,120,110.215208035103,23
148,1997,90,104,124,107.389109018402,34
148,1998,82,97,124,102.810594956845,42
148,1999,86,112,121,109.620249672239,35
148,2000,79,97,120,103.649433606948,41
148,2001,83,100,120,105.998167674412,37
148,2002,84,106,127,110.150577278002,43
149,1993,81,119,158,119.746585719215,77
149,1995,83,102,133,109.539029025797,50
149,1997,100,121,141,124.290011503915,41
149,1998,104,132,149,131.865142889476,45
149,1999,97,118,134,120.39697687507,37
149,2000,97,113,134,118.962206475158,37
149,2001,92,116,138,116.686552844397,46
149,2002,102,125,141,125.181019314579,39
149,2003,102,124,142,126.307547164175,40
149,2004,110,122,143,128.837439468136,33
149,2005,94,117,144,122.610570234168,50
149,2006,97,117,130,119.178691382501,33
149,2007,99,131,148,130.808831143356,49
149,2008,104,124,146,127.553678533976,42
149,2009,96,127,141,128.256587295789,45
149,2011,105,125,137,126.287003000253,32
149,2014,91,111,123,109.909336684195,32
149,2015,92,106,134,115.531295328467,42
150,1994,118,137,158,139.931739123895,40
150,1995,104,123,147,127.793988388557,43
150,1996,117,144,166,144.297063233168,49
150,1998,106,139,158,138.083618992793,52
150,1999,95,116,144,122.859949847089,49
150,2000,91,130,172,134.307923067951,81
150,2001,115,131,151,136.547679696683,36
150,2002,116,127,141,134.364812885021,25
150,2003,105,121,144,126.057364531738,39
150,2004,110,131,144,131.953666705615,34
150,2005,102,125,151,130.52804414871,49
150,2006,94,116,144,122.400802986452,50
150,2007,88,123,158,126.923295382231,70
150,2008,102,123,151,129.773864293103,49
150,2014,74,111,144,111.733816917304,70
150,2015,74,116,156,121.061153743684,82
151,1994,93,109,123,112.251927131219,30
151,1995,91,101,116,107.050894758468,25
151,1996,93,118,133,118.942365224781,40
151,1997,90,110,135,115.401265765252,45
151,1998,89,101,133,112.520011625789,44
151,1999,95,109,130,114.727310118982,35
151,2000,87,102,121,107.171011478656,34
151,2001,86,110,121,108.495401581946,35
151,2002,98,117,134,117.981707380341,36
151,2003,96,105,118,109.770744340266,22
151,2004,82,95,120,103.539006711475,38
151,2005,81,100,125,107.302557941501,44
151,2006,86,95,115,104.517598646957,29
151,2007,71,94,122,99.2914859776541,51
151,2008,88,99,123,106.973748065989,35
151,2009,83,103,114,102.867257785913,31
151,2011,72,87,121,96.9776567060849,49
151,2013,92,106,124,107.306946002785,32
151,2014,73,92,113,96.0205236618672,40
151,2015,89,94,116,102.813867999891,27
152,1994,95,113,135,118.826261898195,40
152,1995,87,100,125,106.614326861732,38
152,1996,95,113,134,115.540405838784,39
152,1997,99,116,123,117.222019158386,24
153,1995,90,118,151,120.14359629928,61
153,1996,95,117,137,120.568206241966,42
153,1997,67,111,146,109.647085931855,79
153,1999,78,109,137,110.138159061909,59
153,2001,74,102,137,107.295131711744,63
153,2003,93,105,121,110.451688900636,28
153,2004,73,105,126,104.997069003701,53
153,2005,89,102,130,108.845970912435,41
153,2006,60,105,136,102.980164180171,76
153,2007,94,105,122,109.84463261519,28
153,2008,88,112,123,110.47265169154,35
153,2009,83,87,104,94.5699774486392,21
153,2014,87,99,108,103.564713138905,21
153,2015,98,107,130,113.293777807334,32
154,2003,75,97,119,100.601785706496,44
154,2004,88,120,151,122.830733820953,63
154,2008,95,116,144,124.148381503722,49
154,2009,79,94,116,99.9723414514278,37
154,2011,81,101,124,103.893813380323,43
155,1995,89,101,113,106.003887668305,24
155,1996,97,113,127,116.869667473414,30
155,1997,85,112,140,116.940315653301,55
155,1998,85,111,136,115.373206067035,51
155,1999,89,109,121,109.247023886397,32
155,2000,98,113,135,117.427425405593,37
155,2002,78,102,128,106.484710040556,50
155,2003,81,105,119,104.403348555802,38
155,2004,75,102,122,102.705392006073,47
155,2005,80,100,123,106.342194552857,43
155,2006,85,103,116,105.506704273565,31
155,2007,81,105,127,107.023811612864,46
155,2008,81,104,129,106.758578585815,48
155,2009,84,93,116,100.266663000812,32
155,2011,74,91,115,95.8917634992899,41
155,2013,87,106,129,111.564504363088,42
155,2014,88,107,129,112.118472560749,41
155,2015,74,94,122,100.364058518058,48
156,1995,95,107,128,110.253205128249,33
156,1996,97,113,127,115.274091524878,30
156,1997,88,111,129,111.630107460178,41
156,1998,92,106,136,114.909090451687,44
156,1999,96,106,127,112.462121211606,31
156,2000,89,111,127,114.340740717489,38
156,2001,93,107,135,115.162298118355,42
156,2002,86,101,129,108.194794148143,43
156,2003,93,114,121,114.084944506101,28
156,2004,105,114,127,118.062296015355,22
156,2005,88,102,130,108.742206075988,42
156,2006,85,106,133,110.154790730015,48
156,2008,92,121,143,120.288863647762,51
156,2009,95,107,139,117.093528274516,44
156,2011,65,111,155,112.832454137992,90
156,2013,102,123,144,125.260932280571,42
156,2015,81,116,151,118.478173797111,70
157,1993,103,115,135,121.041594090622,32
157,1995,87,101,116,105.505183207949,29
157,1996,67,106,154,111.874819401359,87
157,1997,77,101,127,105.429768367704,50
157,1998,95,107,126,112.476549916878,31
157,1999,86,110,130,113.018619496095,44
157,2000,74,102,123,102.890828517576,49
157,2002,88,109,138,112.425809443311,50
157,2006,91,103,115,107.567807433316,24
157,2007,72,88,124,97.3646607954235,52
157,2014,79,93,115,99.8685798147126,36
157,2015,85,106,129,111.017596846052,44
158,1980,97,138,155,134.954744065172,58
158,1981,103,134,156,138.197698064904,53
158,1982,97,127,158,132.444177084545,61
158,1983,100,126,146,127.166806578212,46
158,1984,95,123,149,125.588981259703,54
158,1985,102,139,160,136.87071830912,58
158,1986,104,137,165,139.648821847848,61
158,1987,95,136,150,131.65136394656,55
158,1988,95,137,155,134.122375584565,60
158,1989,88,114,141,118.756859717393,53
158,1990,104,123,150,128.224268670328,46
158,1991,118,138,155,138.692945017001,37
158,1992,109,130,151,132.638550893772,42
158,1993,94,132,155,133.785535436059,61
158,1994,101,130,150,129.136642688568,49
158,1995,94,121,134,121.764354863605,40
158,1996,116,135,155,138.140146324321,39
158,1997,114,137,148,135.824200522257,34
158,1998,115,129,156,136.688306791829,41
158,1999,114,127,149,132.99974651423,35
158,2000,113,134,150,135.37409199572,37
158,2001,114,136,157,139.403417139288,43
158,2002,120,141,155,141.674234422371,35
158,2003,113,131,141,135.201977979752,28
158,2004,110,129,152,136.336698392219,42
158,2005,108,130,152,132.766955877618,44
158,2006,99,130,159,133.870239674052,60
158,2007,118,135,164,140.562010440269,46
158,2008,115,137,155,139.404041575764,40
158,2009,85,130,161,130.175400379481,76
158,2011,86,127,155,130.897161482841,69
158,2013,96,131,157,130.347491123338,61
158,2014,80,114,141,118.912939695646,61
158,2015,86,130,158,128.069440819049,72
159,1997,89,100,113,102.189002557979,24
159,1998,88,100,113,106.032889591519,25
159,1999,78,93,111,96.923468114928,33
159,2000,78,93,117,98.9020833340549,39
159,2001,74,103,137,107.470901570836,63
159,2002,79,106,117,106.559308782638,38
159,2003,82,95,109,98.4735279054734,27
160,1995,60,88,120,93.7874841306288,60
160,1996,93,110,130,114.986111061725,37
160,1997,90,109,128,112.71830987774,38
160,1998,91,100,137,112.055668191935,46
160,1999,89,109,120,108.224530732666,31
160,2000,88,107,123,110.111111087904,35
160,2001,89,100,121,106.094064209955,32
160,2002,101,123,142,124.281249999998,41
160,2003,70,105,135,107.235294113957,65
160,2004,86,94,123,103.47358078999,37
160,2005,83,98,117,102.153846083871,34
160,2006,81,105,129,107.627709270789,48
160,2007,71,95,122,101.770471402605,51
160,2013,96,100,117,109.108743664359,21
160,2014,46,95,140,95.1184331745991,94
160,2015,74,107,138,108.738383966129,64
161,1997,97,112,128,117.115679844298,31
161,1998,102,124,141,122.929114984787,39
161,1999,96,107,133,111.060134680315,37
161,2000,80,108,130,111.101788835772,50
161,2001,93,119,127,118.810392038609,34
161,2003,87,100,120,106.708004275511,33
161,2004,89,102,120,106.902999774211,31
161,2005,88,106,124,110.064000502747,36
161,2006,91,102,125,108.313947848972,34
161,2007,90,109,130,112.604981140105,40
161,2008,99,113,137,119.458512882926,38
161,2009,88,111,127,110.783898278261,39
161,2011,81,102,127,108.605992423063,46
161,2013,99,113,129,117.292382869341,30
161,2014,87,100,126,106.151530022059,39
161,2015,101,114,127,115.701695866552,26
162,1999,98,114,147,122.87259088009,49
162,2000,102,121,139,123.156466022043,37
162,2001,95,123,144,122.123270844731,49
163,1999,102,118,130,121.78956352407,28
163,2000,81,108,140,112.564273799321,59
163,2001,93,114,136,116.903422927955,43
163,2002,101,116,128,118.451355688677,27
163,2003,88,105,115,106.067117506936,27
163,2004,74,97,117,100.96243074292,43
163,2006,67,95,122,96.7750387368286,55
163,2009,74,109,151,114.767792558208,77
163,2011,112,147,172,144.941054575541,60
163,2014,46,88,123,88.6050231334637,77
163,2015,116,123,131,129.598746455828,15
164,1999,81,121,163,124.260115887552,82
164,2000,95,108,125,115.104056459286,30
165,1999,93,124,145,124.401376012757,52
165,2000,108,121,130,124.684968649379,22
165,2001,81,125,158,123.66394034452,77
165,2002,144,151,151,151.000011220671,7
165,2003,95,110,123,113.916283498979,28
165,2004,107,119,126,120.821705021166,19
165,2005,96,114,133,116.944800621226,37
165,2006,105,112,118,115.377574034068,13
165,2007,102,116,130,118.232748226047,28
165,2008,81,114,149,120.913552003175,68
165,2009,88,104,122,107.884153017164,34
165,2011,89,105,123,110.442276008741,34
165,2013,88,111,128,113.162413918214,40
165,2014,53,105,137,102.274165846212,84
166,1999,97,109,133,119.101126659304,36
166,2000,97,119,140,121.026775527983,43
166,2001,95,119,137,120.549060690183,42
166,2002,103,125,139,125.907552296696,36
166,2003,95,118,130,118.785667617486,35
166,2004,96,120,137,121.508608640051,41
166,2005,95,107,129,116.1970467423,34
166,2006,89,109,131,111.7721597069,42
166,2007,87,119,143,120.694008102675,56
166,2008,95,112,137,119.012280502417,42
166,2009,95,116,137,119.27500547609,42
166,2011,94,114,144,121.501765052777,50
166,2014,90,100,126,106.828290999301,36
166,2015,95,116,134,118.11359489269,39
167,1997,96,96,99,98.9999999995954,3
167,2002,121,129,129,129.00000000003,8
168,2000,79,93,108,98.8548463687113,29
168,2001,85,100,123,106.557397511573,38
169,2000,79,103,123,105.129230946335,44
169,2001,85,100,123,106.549141597126,38
170,2000,87,103,122,107.875518662447,35
170,2001,86,100,121,106.647299741802,35
170,2002,85,101,120,107.350080357275,35
170,2003,78,99,120,100.746513849531,42
170,2004,90,104,117,107.833283807291,27
170,2005,78,100,114,100.344096453713,36
170,2006,88,109,127,111.497158683583,39
170,2007,81,97,115,100.719646390852,34
170,2008,85,102,121,108.576593797917,36
170,2009,76,95,119,100.424024473778,43
170,2011,68,81,116,89.9989825356057,48
170,2013,94,117,130,117.110455860827,36
170,2014,81,94,113,99.9445712118827,32
171,2000,87,118,135,116.253572786865,48
171,2001,95,114,133,116.218506553226,38
171,2002,95,106,127,113.333010285338,32
171,2003,93,106,127,112.049788964598,34
171,2004,90,110,132,115.409634790432,42
171,2005,79,92,114,100.655172779221,35
171,2006,81,102,120,101.870658820474,39
171,2007,73,100,126,106.028395675568,53
171,2008,85,107,121,109.061974256563,36
171,2009,81,100,122,105.727558577693,41
171,2011,68,89,106,90.6696819134691,38
171,2013,101,110,130,117.87181508016,29
171,2014,72,86,113,95.0404954131817,41
172,2000,87,102,123,108.528527075076,36
172,2001,93,107,114,107.719747739727,21
172,2002,81,95,113,99.953912193469,32
172,2003,84,105,115,104.870973408004,31
172,2004,91,112,126,113.098486798935,35
172,2005,82,103,120,106.708986881593,38
172,2006,84,102,123,104.219982526927,39
172,2007,81,103,115,103.768102649382,34
172,2013,99,113,130,116.808350166768,31
172,2014,78,92,113,98.2391377662132,35
172,2015,85,101,122,106.286888943031,37
173,2000,87,102,123,108.451169394268,36
173,2001,86,100,122,107.162064802586,36
173,2002,81,95,120,101.501109699831,39
173,2003,74,98,115,101.631774706225,41
173,2004,91,112,126,111.853110912123,35
173,2005,82,96,120,103.702341891186,38
173,2006,88,102,116,104.284361311904,28
173,2007,81,107,128,110.305045905031,47
173,2013,95,107,130,114.603771928033,35
173,2014,78,99,113,100.89906600446,35
173,2015,95,107,129,112.408581820422,34
174,1999,98,103,121,110.161934678546,23
174,2000,92,108,128,114.597193777543,36
174,2001,91,114,132,114.682030245428,41
174,2002,99,117,128,119.748236180673,29
174,2003,85,104,123,107.345628854576,38
174,2004,82,98,123,104.923808002399,41
174,2005,88,100,114,105.522854792248,26
174,2006,87,101,125,107.588461568168,38
174,2007,99,114,135,119.827836577611,36
174,2008,94,112,130,116.927686883031,36
174,2009,95,109,128,110.922681555351,33
174,2011,96,109,121,113.397043224374,25
174,2013,97,109,128,115.91952236494,31
174,2014,85,108,120,108.027211735321,35
174,2015,96,116,138,118.404267700185,42
175,2000,94,107,123,110.813953511854,29
175,2003,86,95,117,101.928571441001,31
175,2004,86,104,117,107.686341101488,31
175,2005,72,106,142,112.981746490355,70
175,2006,81,105,125,106.528727705018,44
175,2007,81,109,144,112.922078881832,63
175,2013,100,116,130,118.919202381578,30
175,2014,88,95,109,100.647809742348,21
175,2015,94,109,130,114.301364890929,36
176,2000,98,110,129,114.433808552745,31
176,2001,93,106,120,110.322901141312,27
176,2002,85,101,120,107.582825821612,35
176,2003,90,101,113,103.020058503638,23
176,2004,88,110,128,109.931005848015,40
176,2005,94,106,131,110.692493950208,37
176,2006,90,103,126,107.362689311968,36
176,2007,89,99,122,106.979023370819,33
176,2008,95,113,134,119.287386216702,39
176,2009,85,103,128,107.442838371404,43
176,2011,79,106,142,111.08511760564,63
176,2013,106,123,135,123.759344331655,29
176,2014,88,108,136,113.130700470309,48
176,2015,85,108,137,111.637816070157,52
177,2000,76,109,145,113.223433130582,69
177,2001,96,107,126,112.017409732072,30
177,2002,69,107,154,115.307245671768,85
177,2003,75,97,128,99.0961291281199,53
177,2004,67,88,115,94.3265805817806,48
177,2005,74,92,102,94.1309131192019,28
177,2006,88,97,102,98.9998171069544,14
177,2008,67,111,145,109.743505837736,78
177,2009,81,93,109,97.4192222870436,28
178,1992,91,111,137,115.305941411859,46
178,1993,82,114,158,121.82422304092,76
178,1995,88,101,122,109.528106004014,34
178,1996,95,113,137,116.188004547853,42
178,1997,88,109,130,112.993421505997,42
178,1998,94,116,141,121.48039424432,47
178,1999,88,109,130,114.494055950684,42
178,2000,94,110,137,117.746371670154,43
178,2001,86,107,130,111.951300834164,44
178,2002,86,116,137,115.263936576154,51
178,2003,81,109,130,110.721247282555,49
178,2004,97,121,144,124.710391568385,47
178,2005,95,116,144,120.215195899372,49
178,2006,102,115,141,122.706813365151,39
178,2007,88,116,144,120.371415108616,56
178,2008,102,121,144,126.98774858979,42
178,2009,84,104,144,113.455327735617,60
178,2011,88,127,158,127.829955854657,70
178,2013,99,130,155,134.137039443639,56
178,2014,60,87,116,92.6832230475501,56
179,2000,87,102,123,107.775046545222,36
179,2001,93,107,122,110.273019758277,29
179,2002,75,95,113,99.2555549644871,38
179,2003,84,105,126,108.247561522533,42
179,2004,91,112,128,116.94346259238,37
179,2005,64,103,144,109.007685049024,80
179,2006,84,94,116,100.071904642536,32
179,2007,81,103,131,106.265312494791,50
179,2013,99,106,123,111.813087254077,24
179,2014,78,99,121,103.274585898263,43
179,2015,101,107,129,114.235359321066,28
180,2003,84,100,124,104.059040329853,40
180,2004,77,88,107,96.0231345226615,30
180,2005,60,95,136,101.392278401398,76
180,2006,81,95,115,100.594717931559,34
181,2002,104,120,143,125.165277832617,39
181,2003,96,122,131,117.662929441453,35
181,2004,77,104,132,107.334081794708,55
181,2005,88,110,138,113.752096544319,50
181,2007,88,125,137,121.772782770764,49
181,2008,91,107,125,109.966257257348,34
181,2009,81,100,129,105.143533384628,48
181,2011,93,124,143,127.44113266419,50
182,2003,94,105,115,106.948210082143,21
182,2004,86,116,143,120.147613361866,57
182,2005,82,109,137,114.24670578183,55
182,2006,81,116,144,117.703901324575,63
182,2007,81,95,120,101.839326690542,39
182,2009,67,101,144,105.528218555977,77
182,2011,95,112,115,109.666675102377,20
182,2013,81,103,137,110.343326829622,56
182,2014,74,109,144,113.60102869437,70
183,2003,85,112,126,110.192539909667,41
183,2004,91,112,130,113.178204077577,39
183,2005,89,104,125,107.06986225602,36
183,2006,90,103,121,108.556057822343,31
184,2003,89,106,131,108.916754191056,42
184,2004,93,114,134,117.273437425323,41
184,2005,85,106,131,111.430034116083,46
184,2006,88,103,123,107.627665190769,35
184,2007,86,107,128,110.026141340238,42
184,2008,92,114,129,115.178983832895,37
184,2009,85,101,125,107.366775337926,40
184,2011,81,102,123,103.026666662799,42
184,2013,99,113,129,115.630182416493,30
184,2014,78,92,120,100.291160284031,42
184,2015,85,101,122,106.394522943118,37
186,2004,81,109,144,115.345452468945,63
186,2005,83,102,137,110.213277732566,54
186,2006,116,123,130,128.108413916637,14
186,2007,82,109,137,111.449235177068,55
186,2008,83,109,137,112.326795452785,54
186,2009,116,123,130,127.144497939643,14
187,2004,75,119,144,115.838871622712,69
187,2005,98,116,144,121.924544189841,46
187,2006,85,119,137,118.456537026355,52
187,2008,95,109,130,113.034893455209,35
188,2004,77,108,136,110.911428928834,59
188,2005,85,104,116,104.626177070832,31
188,2006,92,102,112,104.761786710789,20
188,2007,86,97,123,105.527150396787,37
188,2008,95,109,137,115.361277882951,42
188,2011,94,110,130,114.965858452609,36
188,2013,92,109,128,111.556649445155,36
188,2014,88,111,139,116.970335272536,51
188,2015,90,102,145,113.197272252276,55
190,2006,89,107,121,109.041350158037,32
190,2007,96,108,131,115.272867623186,35
190,2008,79,116,150,118.700621768207,71
190,2009,85,100,118,103.527634288679,33
190,2011,89,106,120,106.939791184103,31
190,2013,94,111,121,111.48863584639,27
190,2014,88,100,123,107.698718203829,35
190,2015,91,119,139,118.670983010812,48
191,2005,88,101,113,104.481447404641,25
192,2004,81,109,125,108.777175503375,44
192,2005,92,107,121,109.31358915425,29
192,2006,85,112,116,109.891389758925,31
192,2007,91,112,124,112.420904684392,33
192,2009,88,101,116,105.335342502947,28
192,2011,88,108,121,108.353519430585,33
192,2013,98,107,126,112.166013151528,28
192,2014,79,104,116,106.016354195178,37
192,2015,95,114,127,117.009707024096,32
193,1979,84,123,156,122.370521228844,72
193,1980,95,123,151,126.408736853921,56
193,1981,98,116,138,119.588825249616,40
193,1982,88,110,133,114.951868719112,45
193,1983,94,108,130,116.199379563039,36
193,1984,89,103,120,108.42130681354,31
193,1985,67,108,159,113.418300506347,92
193,1986,53,109,152,109.143596578937,99
193,1987,88,110,137,115.478656008439,49
193,1988,84,95,124,100.437402497715,40
193,1989,74,95,114,100.608916251286,40
193,1990,89,103,123,107.785497423445,34
193,1991,108,120,135,125.502400250213,27
193,1992,81,97,130,106.398285508014,49
193,1993,83,102,128,106.195405405982,45
193,1994,98,116,137,118.6963322434,39
193,1995,45,88,137,94.0919684239053,92
193,1996,85,107,127,113.140840233605,42
193,1997,84,113,137,117.417752729773,53
193,1998,86,109,135,113.761151243575,49
193,1999,86,99,126,104.734941742392,40
193,2000,86,113,130,113.210934283889,44
193,2001,88,105,126,108.660629571585,38
193,2002,87,115,129,114.492753620134,42
193,2003,97,111,137,115.079057685118,40
193,2004,88,111,137,117.888048866053,49
193,2005,87,104,131,107.829268294088,44
193,2006,89,103,136,112.000881432351,47
193,2007,71,110,146,114.253994209924,75
193,2008,88,125,144,122.305106473619,56
193,2009,83,108,135,112.792968341283,52
193,2011,104,126,154,127.790289582662,50
193,2013,100,108,140,116.321299032125,40
193,2014,91,101,123,107.112261281947,32
193,2015,94,107,134,114.685278331708,40
194,2005,94,119,136,118.710087084436,42
194,2006,93,109,124,112.656303861909,31
194,2007,95,123,158,126.514276504505,63
195,2006,92,106,120,110.321728756335,28
195,2007,95,114,135,116.344827597767,40
195,2008,94,110,125,113.215382231957,31
195,2009,86,101,116,104.999999995424,30
195,2011,92,106,121,110.359236488078,29
195,2013,97,102,113,107.37254899179,16
195,2014,92,108,120,108.55405406253,28
195,2015,88,112,134,114.296419761831,46
196,2005,87,111,122,109.90203602698,35
500,1996,108,125,141,129.034275188869,33
501,1996,109,125,146,127.300742215823,37
989,1997,95,126,144,124.372321119029,49
989,1999,114,125,125,125.000000000358,11
990,2004,126,134,151,138.500721135088,25
990,2005,131,144,158,149.262722396823,27
990,2006,109,116,130,121.663049818267,21
990,2011,104,125,151,131.050148790762,47
991,1994,111,130,151,135.830300221042,40
991,1995,111,131,147,133.280291211649,36
991,1996,117,138,159,142.233378423487,42
991,1997,123,134,157,141.072349112573,34
991,1998,122,135,155,139.465212176466,33
991,1999,114,128,142,130.900088616088,28
991,2000,117,133,151,136.535984586915,34
991,2001,114,136,158,138.578802030584,44
991,2002,120,137,155,141.267619759392,35
991,2003,115,127,148,133.703003748692,33
991,2004,114,127,148,136.521524982182,34
991,2005,117,131,152,136.693741349365,35
991,2006,109,131,152,135.101827238854,43
991,2007,123,137,164,143.268615327486,41
991,2008,123,136,156,143.035959834481,33
991,2009,121,136,161,142.719915386671,40
991,2011,116,137,155,141.100166355159,39
991,2013,106,136,149,136.27411690335,43
991,2015,105,130,144,130.712302410518,39
992,1993,123,132,139,137.271402810588,16
992,1994,116,147,172,145.586407560918,56
992,1995,116,130,151,136.911914310481,35
992,1997,109,116,116,116.041459078408,7
992,2000,112,130,157,136.875139278969,45
992,2001,102,128,158,133.625589573147,56
992,2002,143,149,164,155.583892061278,21
992,2003,70,95,127,99.4046628919347,57
992,2004,88,121,162,130.379946388638,74
992,2005,88,111,123,110.239486193053,35
992,2006,95,108,116,113.459684431683,21
992,2007,95,95,101,100.832045326471,6
993,2013,88,122,151,122.945929050591,63
994,1993,85,93,119,103.196116488255,34
994,1994,50,96,130,96.5756647593575,80
994,1995,87,97,115,102.403180024387,28
994,1996,95,106,121,109.546341463449,26
994,1997,84,99,120,104.074568336694,36
994,1998,85,99,114,102.713749764907,29
994,1999,78,93,107,98.0317002901311,29
994,2000,80,94,116,100.702702169931,36
994,2001,86,100,121,104.90343551873,35
994,2002,78,95,115,100.312786413457,37
994,2003,78,92,106,93.230393264656,28
994,2004,83,92,113,99.060333139622,30
994,2005,78,97,113,100.118296500617,35
994,2006,81,94,109,99.8429010258543,28
994,2007,80,95,116,99.8546257473165,36
994,2008,85,101,113,103.019867535227,28
994,2009,86,93,122,103.264189119459,36
994,2011,75,92,116,97.8584421188596,41
994,2013,101,108,123,112.641237035849,22
994,2015,85,102,116,104.200166732448,31
995,1993,92,107,127,109.494907573477,35
995,1994,95,113,137,119.924657092752,42
995,1995,96,111,129,113.017800701062,33
995,1996,96,109,127,112.944033088203,31
995,1997,88,109,122,109.273367714756,34
995,1998,85,93,115,102.613157594696,30
995,1999,85,107,130,110.167398847992,45
995,2000,87,102,129,109.136012125169,42
995,2002,85,99,125,107.767576109332,40
995,2003,78,95,124,103.692996077237,46
995,2004,80,102,120,103.761514193974,40
995,2005,83,93,109,97.8199848949993,26
995,2006,81,102,115,103.818015718433,34
995,2007,79,102,122,106.182699085188,43
995,2008,91,107,130,109.547567901986,39
995,2011,84,93,131,105.667060574294,47
995,2013,96,110,130,114.175765775833,34
995,2014,82,93,113,100.208657452521,31
995,2015,86,100,121,106.270716156717,35
996,1995,75,96,117,100.664116969754,42
996,1996,110,129,146,131.211216826655,36
996,1997,93,100,100,100.189687205852,7
996,1998,78,92,106,96.4893288734475,28
996,1999,77,99,126,104.478108029353,49
996,2000,82,89,89,89.0000000000919,7
996,2002,109,116,116,117.204039195681,7
996,2003,72,93,121,99.7272647739288,49
996,2004,56,91,133,95.6230501232177,77
996,2005,102,111,111,112.166666665671,9
996,2011,69,102,130,104.597645211452,61
996,2013,102,108,129,115.793510329265,27
996,2014,67,79,100,83.6777603679333,33
996,2015,92,106,158,113.860910523023,66
997,1994,144,144,151,150.925272363203,7
997,1995,101,115,137,122.272744613572,36
997,1996,108,127,141,129.43295950153,33
997,1997,99,120,141,123.912133252627,42
997,1998,116,127,135,129.123131239822,19
997,1999,112,125,138,127.461512432681,26
997,2000,109,123,145,129.243195040604,36
997,2001,107,117,131,118.808356055739,24
997,2002,103,122,141,124.872001230188,38
997,2003,84,99,115,103.087839002556,31
997,2004,89,104,128,111.187329449384,39
997,2005,92,106,127,110.518856319095,35
997,2006,102,108,123,114.908371124649,21
997,2007,109,118,118,118.201714573251,9
997,2008,93,113,121,112.89021576382,28
997,2009,58,87,118,90.2749609247335,60
997,2014,88,113,120,112.598043339383,32
998,1993,86,109,135,112.775040776102,49
998,1994,92,109,120,112.602997556727,28
998,1995,88,108,122,110.811316330681,34
998,1996,99,120,136,122.246556267212,37
998,1997,95,123,134,120.817380465884,39
998,1998,99,115,127,120.089163649826,28
998,1999,93,114,120,114.317257663511,27
998,2000,96,110,131,115.46530363083,35
998,2001,87,104,116,109.014669103886,29
998,2002,81,95,129,104.000765118826,48
998,2003,86,95,122,101.986245759367,36
998,2004,83,104,116,105.12335756262,33
998,2005,89,98,111,102.168558350701,22
998,2006,78,95,109,99.1649159929259,31
998,2007,80,95,123,101.944569333519,43
998,2008,88,102,123,105.811643556249,35
998,2009,79,92,114,98.0869156188367,35
998,2011,83,104,125,105.531290507909,42
999,1994,92,106,120,109.838844956776,28
999,1995,89,99,113,103.728448272971,24
999,1996,96,107,127,112.135536950621,31
999,1997,76,98,121,102.701981352571,45
999,1998,86,100,133,107.852507841802,47
999,1999,87,109,120,108.63163531457,33
999,2000,95,111,122,112.779533003545,27
999,2001,87,102,130,109.314201952176,43
999,2002,95,110,129,116.774302245905,34
999,2003,81,100,126,106.125578693154,45
999,2004,97,110,120,111.424083962917,23
999,2005,83,103,126,106.511709658077,43
999,2006,84,95,108,99.3698836444499,24
999,2007,73,87,115,95.1387640100334,42
999,2008,88,105,121,107.9980507332,33
999,2009,84,92,119,101.487253427819,35
999,2011,75,105,123,104.00037405262,48
999,2013,96,110,123,112.696182083705,27
999,2014,73,93,120,99.7989061359726,47
999,2015,85,100,116,103.432646149349,31
1001,2006,91,123,158,124.039935800483,67
1001,2007,90,120,151,122.687422835067,61
1001,2008,109,137,158,137.168343575706,49
1001,2009,86,129,158,126.550939593717,72
1001,2011,90,123,151,123.840296079549,61
1001,2013,96,130,156,129.658891711492,60
1001,2014,81,113,151,119.349609312442,70
1001,2015,81,116,149,120.25732949503,68
1004,2011,82,110,144,112.440789466735,62
1004,2013,96,108,135,114.733535367847,39
1004,2014,85,106,135,110.839694642026,50
1004,2015,85,100,121,104.65789473685,36
1005,1980,102,131,155,133.003735764642,53
1005,1981,109,132,149,132.78537672751,40
1005,1982,99,128,157,131.580381571661,58
1005,1983,99,120,149,128.805659006456,50
1005,1984,108,133,153,134.418192343283,45
1005,1985,108,139,165,141.853199987572,57
1005,1986,100,137,153,134.528030764272,53
1005,1987,96,137,161,134.51706200654,65
1005,1988,95,129,157,131.363673039718,62
1005,1989,82,114,138,112.829170545533,56
1005,1990,88,120,144,122.168986951862,56
1005,1991,114,134,157,137.780050309999,43
1005,1992,101,128,143,128.606814801117,42
1005,1993,99,127,148,131.365551315577,49
1005,1994,93,120,143,125.86052202162,50
1005,1995,92,120,141,122.413961052638,49
1005,1997,105,131,155,134.170311589463,50
1005,1998,110,138,152,135.232286540911,42
1005,1999,108,127,165,135.630987173347,57
1005,2000,99,134,156,134.601249931638,57
1005,2001,115,137,159,140.496109484033,44
1005,2002,107,139,165,141.69304584476,58
1005,2003,102,128,148,129.355172195643,46
1005,2004,110,127,153,131.174004243597,43
1005,2005,102,124,151,130.454085347138,49
1005,2006,95,126,148,127.057273724666,53
1005,2007,88,130,164,132.863488463615,76
1005,2008,105,130,152,131.949416487759,47
1005,2009,88,117,143,120.177080402485,55
1005,2011,87,121,153,125.343623856876,66
1005,2013,92,113,142,121.123642582253,50
1005,2014,85,113,137,114.564958113308,52
1005,2015,94,122,139,120.543955577349,45
1006,2002,87,110,128,110.753509663445,41
1006,2003,86,109,121,109.582570009765,35
1006,2005,95,106,129,113.54658384951,34
1006,2006,92,115,130,115.336051530557,38
1006,2007,89,110,127,111.046323600681,38
1006,2008,85,113,136,115.91735820776,51
1006,2009,95,109,127,111.992857147393,32
1006,2011,82,102,127,106.025411640055,45
1006,2013,98,112,128,115.149204351806,30
1006,2014,90,107,120,108.79435386483,30
1006,2015,85,101,130,109.757559424619,45
1007,1993,88,113,154,121.419577606752,66
1007,1994,100,123,147,123.198603092307,47
1007,1995,86,110,133,115.344358765136,47
1007,1996,101,125,151,125.662652217401,50
1007,1997,100,130,151,131.866122867119,51
1007,1998,94,128,149,127.927066210138,55
1007,1999,102,120,149,126.979766838737,47
1007,2000,105,126,145,126.869179901419,40
1007,2001,102,122,143,124.365268907689,41
1007,2002,110,127,154,133.499190979416,44
1007,2003,95,123,151,126.156523777585,56
1007,2004,102,126,161,134.27939842341,59
1007,2005,99,120,150,128.653717817222,51
1007,2006,90,108,139,117.080879312629,49
1007,2007,102,131,160,135.364036431238,58
1007,2008,102,123,136,124.279781116984,34
1007,2009,84,109,153,117.955376897119,69
1007,2011,97,123,153,126.267912173846,56
1007,2013,100,123,149,125.509845281072,49
1007,2014,87,106,131,111.660395191549,44
1007,2015,85,114,143,119.887318429295,58
1008,2000,105,137,165,137.631900814453,60
1009,2003,81,97,119,101.235392542395,38
1009,2004,76,104,132,105.251239549562,56
1009,2005,88,108,131,112.000905715733,43
1009,2006,88,102,121,106.83158545718,33
1009,2007,77,88,115,96.4660009194679,38
1009,2008,78,113,129,113.764350087593,51
1009,2009,74,96,130,100.122715401982,56
1009,2011,67,87,115,92.3526301611626,48
1009,2013,88,102,124,110.845617649913,36
1009,2014,80,95,114,100.486195141247,34
1009,2015,79,92,122,101.153455576249,43
1010,2001,81,94,106,101.692403524598,25
1010,2002,89,108,133,112.750266542086,44
1010,2003,87,101,125,106.768552098363,38
1010,2004,89,110,128,110.557859429429,39
1010,2005,90,102,119,103.26962590741,29
1010,2006,96,108,121,112.871235583434,25
1010,2007,80,94,123,100.407030636063,43
1010,2008,84,105,132,110.474112075011,48
1010,2014,88,130,158,129.70497799781,70
1010,2015,102,116,130,120.119563756575,28
1011,2004,86,110,120,109.137987202035,34
1011,2005,87,101,124,107.67403937249,37
1011,2006,90,99,120,107.171044029007,30
1011,2007,53,102,151,105.250856277324,98
1011,2008,88,109,130,113.665385511322,42
1011,2009,89,100,130,109.053566736053,41
1011,2011,87,96,131,107.933790637208,44
1011,2013,87,108,132,110.102611284001,45
1013,1997,76,104,123,103.276572285577,47
1013,1998,82,109,138,113.340649815678,56
1013,1999,80,102,123,103.617377802474,43
1013,2000,79,95,114,99.4407138623015,35
1013,2001,85,105,123,105.762444441292,38
1013,2002,79,108,134,114.027677780318,55
1013,2003,77,100,124,102.982017285237,47
1013,2004,81,109,137,112.77009175048,56
1013,2005,81,95,125,103.066784919936,44
1013,2006,80,95,107,99.6463428776621,27
1013,2007,66,97,123,99.8082252953307,57
1013,2008,53,95,151,101.742107702551,98
1013,2009,74,94,123,100.681779710438,49
1013,2011,74,89,122,98.8084666452675,48
1013,2013,96,101,130,111.596831903098,34
1013,2014,78,100,129,106.62289926119,51
1013,2015,85,100,130,105.127107439938,45
1014,1991,96,113,134,120.167882801524,38
1014,1992,83,102,115,102.594805876333,32
1014,1993,85,99,123,105.113475176799,38
1014,1994,87,100,121,106.137096774293,34
1014,1995,86,99,113,100.040650406991,27
1014,1996,90,107,121,109.794569219589,31
1014,1997,79,99,121,103.196262763189,42
1014,1998,77,101,127,104.715464982655,50
1014,1999,85,99,115,103.57677403635,30
1014,2000,87,109,120,108.886542733832,33
1014,2001,52,94,144,100.582417568057,92
1014,2002,86,102,124,108.864424375311,38
1014,2003,79,101,124,103.299365696718,45
1014,2004,74,94,115,98.8762608862619,41
1014,2005,82,93,114,98.581546063408,32
1014,2006,78,99,116,100.60919290326,38
1014,2007,73,89,110,95.2908536369318,37
1014,2008,78,101,121,105.478947146565,43
1014,2009,72,92,106,94.6050606178946,34
1014,2011,75,86,108,91.4265734285565,33
1014,2013,97,109,123,111.232603010603,26
1014,2014,80,100,114,103.715392108963,34
1014,2015,86,100,113,103.077747987466,27
1016,1990,91,107,134,113.009909919726,43
1016,1991,102,125,146,126.356641741192,44
1016,1992,83,110,137,112.702498796804,54
1016,1993,81,108,142,114.810524327809,61
1016,1994,88,114,127,114.276833384492,39
1016,1995,83,110,131,108.971727852341,48
1016,1996,95,114,135,117.572738289303,40
1016,1997,85,106,137,114.289914903995,52
1016,1998,88,114,141,116.915786248866,53
1016,1999,86,108,140,115.01375150257,54
1016,2000,94,117,146,120.340250500111,52
1016,2001,93,121,149,122.469696960264,56
1016,2002,108,134,156,136.650191378758,48
1016,2003,100,131,142,128.131081073713,42
1016,2004,110,128,150,133.307893133711,40
1016,2005,102,129,155,132.875684518672,53
1016,2006,103,137,163,134.729070536613,60
1016,2007,109,139,165,140.001028159151,56
1016,2008,104,136,165,138.087947764038,61
1016,2009,93,138,158,133.967059619492,65
1016,2011,85,132,160,129.116603217417,75
1016,2013,99,122,142,124.721163402749,43
1016,2014,80,113,135,113.272554493258,55
1016,2015,85,130,159,131.004342178986,74
1017,1996,100,108,127,115.899396392819,27
1017,1997,78,100,130,107.111842112831,52
1017,1998,91,113,141,115.082925687626,50
1017,1999,94,115,134,115.930885519768,40
1017,2000,87,113,134,114.826538706941,47
1017,2002,95,120,143,125.676211924102,48
1017,2003,85,109,132,113.897814905063,47
1017,2004,92,115,139,119.817523963286,47
1017,2005,88,106,134,113.618129885277,46
1017,2006,79,103,137,111.118399443812,58
1017,2007,74,115,151,117.036211675027,77
1017,2008,94,120,152,124.475373010273,58
1017,2009,85,109,151,116.033754721783,66
1017,2011,80,101,151,112.634760043119,71
1017,2013,99,123,148,126.989130308319,49
1017,2014,80,108,137,111.692647641729,57
1017,2015,83,109,144,114.789707257939,61
1018,1986,106,137,162,139.780473381525,56
1018,1987,100,128,161,132.010500479212,61
1018,1988,96,131,159,133.595886369983,63
1018,1989,83,109,144,115.892653931567,61
1018,1990,101,122,143,125.549973634971,42
1018,1991,117,134,156,138.5424343216,39
1018,1992,93,120,151,126.257772037257,58
1018,1993,92,125,159,129.429068061789,67
1018,1994,101,126,144,125.026699813557,43
1018,1995,86,113,135,115.256718791413,49
1018,1996,108,125,141,129.034275188869,33
1018,1997,88,120,144,123.726786875198,56
1018,1998,116,134,158,139.39305361665,42
1018,1999,86,114,144,118.444333875662,58
1018,2000,95,130,152,127.986322674138,57
1018,2001,95,130,165,134.231295058925,70
1018,2002,104,130,161,132.698711722735,57
1018,2003,95,126,152,126.318604344226,57
1018,2004,104,130,152,132.611233596869,48
1018,2005,95,125,151,128.703754691926,56
1018,2006,93,123,152,129.11989534054,59
1018,2007,115,147,166,146.041588555627,51
1018,2008,107,137,166,141.389714348079,59
1018,2009,83,129,159,128.95582174507,76
1018,2011,89,131,152,130.64175256137,63
1018,2013,101,130,157,132.438555459059,56
1018,2014,86,126,153,124.462902447386,67
1018,2015,86,119,144,119.074183977414,58
1019,1986,107,142,162,144.862649470433,55
1019,1987,99,143,165,141.666317317279,66
1019,1988,111,138,168,140.62399456971,57
1019,1989,88,124,141,120.549009361628,53
1019,1990,102,122,143,125.529565220005,41
1019,1991,116,135,157,138.643496053358,41
1019,1992,102,120,143,125.860902965709,41
1019,1993,99,136,155,134.926667920092,56
1019,1994,99,125,142,126.713161325927,43
1019,1995,95,115,136,120.197851765855,41
1019,1996,109,125,146,127.300742215823,37
1019,1997,100,130,154,127.973193174088,54
1019,1998,114,135,151,136.701566951178,37
1019,1999,99,127,155,129.185040786246,56
1019,2000,99,127,158,129.72302297343,59
1019,2001,106,136,161,139.669711546876,55
1019,2002,104,127,155,134.195035912639,51
1019,2003,112,126,147,132.323326341613,35
1019,2004,102,121,152,129.422706602452,50
1019,2005,95,126,159,130.629929105697,64
1019,2006,98,118,151,125.844668549108,53
1019,2007,102,130,158,131.819736917327,56
1019,2008,102,133,158,135.356380696924,56
1019,2009,88,129,158,130.27409414195,70
1019,2011,92,131,155,130.96600806725,63
1019,2013,99,130,157,133.736530443772,58
1019,2014,85,114,144,115.90175290539,59
1019,2015,85,122,160,124.457934788866,75
1021,1991,118,130,154,138.067579758298,36
1021,2002,90,118,146,120.276648384904,56
1021,2003,89,118,132,116.567235864954,43
1021,2004,102,123,143,126.386783085803,41
1021,2005,93,114,142,121.222378773349,49
1021,2006,86,107,137,114.69813046743,51
1021,2007,88,109,134,114.555314023562,46
1021,2008,76,111,137,112.886840222549,61
1021,2009,82,103,137,109.456844925479,55
1021,2011,80,109,144,116.095188991466,64
1021,2013,97,109,132,116.278166043271,35
1021,2014,83,97,125,105.09055737232,42
1021,2015,88,102,130,109.373879253537,42
1022,1996,102,123,151,129.405374140346,49
1022,2003,98,126,148,126.982484296375,50
1022,2004,111,128,156,134.117978638471,45
1022,2005,95,125,155,128.869672807135,60
1022,2006,93,116,152,123.356079461794,59
1022,2007,98,135,164,136.200266247684,66
1022,2008,107,129,161,136.864641557718,54
1022,2009,89,124,153,123.496897679684,64
1022,2011,88,123,155,126.382152738217,67
1022,2013,105,113,143,123.905036626545,38
1022,2014,84,117,135,116.130518227295,51
1022,2015,91,109,150,118.516042782147,59
1023,2001,102,130,158,134.361835302987,56
1023,2002,117,140,158,143.05831247502,41
1023,2004,108,130,144,130.26874121232,36
1024,1990,80,93,117,98.3700594644548,37
1024,1991,102,113,137,120.17716842449,35
1024,1992,85,101,121,107.678996736868,36
1024,1993,85,113,135,114.511571675936,50
1024,1994,92,107,127,113.242267861337,35
1024,1995,87,101,123,108.010421625459,36
1024,1996,101,116,127,117.713543439178,26
1024,1997,84,106,130,109.001824880311,46
1024,1998,89,108,127,113.04109913643,38
1024,1999,85,109,120,110.244044524878,35
1024,2000,88,109,129,112.126636702934,41
1024,2001,94,107,132,113.166172107169,38
1024,2002,87,106,129,112.439453125,42
1024,2003,85,103,124,109.672112499413,39
1024,2004,86,110,127,111.350408002726,41
1024,2005,88,106,123,109.149054505858,35
1024,2006,89,102,121,106.63093832287,32
1024,2007,80,102,121,105.702126281381,41
1024,2008,85,112,128,112.166864665108,43
1024,2009,84,102,121,105.959377403602,37
1024,2011,75,95,123,100.50922109891,48
1024,2013,99,113,129,115.719720512759,30
1024,2014,78,105,121,103.224719087108,43
1024,2015,85,100,124,106.606022582173,39
1025,2006,95,116,130,116.569435370507,35
1025,2007,88,109,137,116.2975767786,49
1029,2001,93,107,137,115.764151105689,44
1030,2001,88,123,151,124.742195598003,63
1030,2002,109,131,150,133.28798779563,41
1031,2000,81,95,116,103.19444702409,35
1031,2001,82,104,132,107.679999996404,50
1031,2002,79,109,134,111.944297067845,55
1031,2003,76,104,127,103.488016579174,51
1031,2005,83,95,125,104.364662341196,42
1031,2006,82,93,118,101.086619210611,36
1031,2007,73,103,130,105.056168981397,57
1031,2008,84,104,130,107.20565241728,46
1031,2009,53,95,144,100.211923518473,91
1031,2011,74,105,134,107.656336065199,60
1031,2013,96,111,130,113.448156010475,34
1031,2014,74,94,114,99.6795307641527,40
1031,2015,86,101,121,103.997106210678,35
1032,1992,81,102,122,103.880351063824,41
1032,1993,85,108,127,109.168831163757,42
1032,1994,93,100,121,106.947368419352,28
1032,1995,82,92,106,97.5248947043387,24
1032,1996,93,107,121,111.623384968141,28
1032,1997,79,99,120,104.649960694602,41
1032,1998,88,100,121,107.212895617244,33
1032,1999,93,108,121,109.49756003444,28
1032,2000,87,108,130,111.332840968167,43
1032,2001,86,102,122,107.359139784919,36
1032,2002,85,106,127,110.04395794012,42
1032,2003,86,101,124,104.888711215788,38
1032,2004,80,99,129,106.710843398809,49
1032,2005,89,100,121,106.191496836905,32
1032,2006,90,99,120,104.945129370493,30
1032,2007,73,94,115,98.8096040888326,42
1032,2008,85,106,127,110.590395472902,42
1032,2009,83,92,120,99.7147534056874,37
1032,2011,74,86,121,96.5756401373618,47
1032,2013,86,109,123,110.58553066153,37
1032,2014,80,93,116,99.8607934938874,36
1032,2015,84,92,121,101.039595610763,37
1034,1989,80,104,124,105.016389989315,44
1034,1990,87,106,135,113.859231113062,48
1034,1991,101,123,151,126.971220494496,50
1034,1992,86,108,143,116.310733594312,57
1034,1993,88,102,139,111.485924943371,51
1034,1994,99,113,144,120.893967429983,45
1034,1995,86,110,137,113.220858644222,51
1034,1996,97,113,143,122.250828301643,46
1034,1997,100,130,152,130.282249223825,52
1034,1998,99,128,149,131.440407629072,50
1034,1999,93,120,149,122.919235817009,56
1034,2000,98,123,144,127.065875399749,46
1034,2001,94,122,151,125.042559179472,57
1034,2002,102,127,155,134.280110592045,53
1034,2003,87,115,144,120.230366018453,57
1034,2004,86,114,154,122.461396689783,68
1034,2005,94,120,144,125.15380991151,50
1034,2006,97,108,151,121.031340173469,54
1034,2007,95,132,156,134.644710355142,61
1034,2008,93,123,151,124.566110935827,58
1034,2011,90,116,153,120.868472691061,63
1034,2013,100,123,149,125.199126191015,49
1034,2014,93,106,140,115.932837394001,47
1034,2015,96,114,143,119.657679368598,47
1035,1998,88,109,147,115.051821443191,59
1035,1999,81,102,137,110.042831758548,56
1035,2000,88,108,137,111.317528108414,49
1035,2001,87,103,135,111.904606289881,48
1035,2002,84,104,136,109.911504618767,52
1035,2003,81,100,126,106.875038240083,45
1035,2004,82,116,152,121.321775123157,70
1035,2005,80,107,122,107.954923317723,42
1035,2006,82,102,125,103.345135807195,43
1035,2007,73,98,130,102.523401170564,57
1035,2008,77,102,137,106.933107338754,60
1035,2011,71,95,158,108.712561201886,87
1035,2013,81,109,143,114.718569250284,62
1035,2014,83,94,113,101.517200469027,30
1035,2015,80,110,144,112.592635133191,64
1036,2001,93,107,130,114.59933674835,37
1036,2002,95,124,137,123.276782371481,42
1036,2003,85,104,124,108.27067325191,39
1036,2004,97,116,136,117.941171957275,39
1036,2005,80,112,131,110.852259645979,51
1036,2006,85,102,121,106.370691826629,36
1036,2007,73,102,128,106.754523956399,55
1036,2008,87,109,137,113.058487177687,50
1036,2009,81,105,130,108.071449735136,49
1036,2011,81,102,131,107.01080967655,50
1036,2013,95,110,129,114.014349476414,34
1036,2014,88,103,120,106.936101304776,32
1036,2015,79,92,123,102.807481525007,44
1037,1987,90,109,137,114.687235564653,47
1037,1988,78,111,144,113.167613637102,66
1037,1989,82,104,140,108.641442716019,58
1037,1990,90,109,140,116.353647276133,50
1037,1991,101,130,148,131.190585546396,47
1037,1992,87,111,136,114.887732270191,49
1037,1993,81,102,129,107.353108225533,48
1037,1994,89,110,137,115.314135162485,48
1037,1995,82,101,138,112.029650214249,56
1037,1996,95,126,142,125.403715865086,47
1037,1997,98,114,146,120.812594242637,48
1037,1998,91,115,141,116.901091839879,50
1037,1999,86,109,134,113.595632016873,48
1037,2000,89,110,137,114.849410317721,48
1039,1987,84,100,127,107.482661831339,43
1039,1988,75,91,109,94.6315789450724,34
1039,1989,74,79,103,87.805412824139,29
1039,1991,95,113,130,115.699236676759,35
1039,1992,72,87,116,97.3586555004517,44
1039,1993,76,94,123,99.4078092061318,47
1039,1994,78,105,125,105.228758135004,47
1039,1995,79,93,114,98.6069363980621,35
1039,1996,84,100,121,105.058394143101,37
1039,1997,84,99,123,105.440000001294,39
1039,1998,82,102,116,103.038626606523,34
1039,1999,79,93,114,99.1614173223133,35
1039,2000,81,95,112,101.188690634201,31
1039,2011,72,92,118,99.9099999605859,46
1039,2013,86,92,113,100.536723168987,27
1039,2014,98,107,125,108.749999968087,27
1039,2015,71,93,113,96.4754097979956,42
1040,1990,78,105,133,109.765954647411,55
1040,1992,81,112,137,112.557343910884,56
1040,1993,86,114,137,118.222518567442,51
1040,1994,89,104,125,107.725296529362,36
1040,1995,88,104,132,109.669404986209,44
1040,1996,95,113,135,117.65566664873,40
1040,1997,85,100,130,109.619417173282,45
1040,1998,83,101,140,109.534789754368,57
1040,1999,85,99,133,108.638119045876,48
1040,2000,89,109,134,114.222642884793,45
1040,2001,84,104,132,107.758456039439,48
1040,2002,81,106,137,109.84952006975,56
1040,2003,81,100,127,105.583026078483,46
1040,2004,82,110,144,114.29750743367,62
1040,2005,88,106,147,115.647955789703,59
1040,2006,90,108,143,114.574937050745,53
1040,2007,78,109,160,117.927729315057,82
1040,2008,87,121,152,122.717699118292,65
1040,2009,81,101,146,113.334833809281,65
1040,2011,81,112,154,116.670371693287,73
1040,2013,95,113,141,120.355066681751,46
1040,2014,86,108,129,110.948673544724,43
1040,2015,80,100,129,107.133477447632,49
1044,1995,86,103,120,107.236854823831,34
1044,1996,95,109,130,113.470337158661,35
1044,1997,76,98,124,100.8132764431,48
1044,1998,81,102,123,105.286086110244,42
1044,1999,84,100,123,102.939805942532,39
1044,2000,78,93,113,99.4182291759389,35
1044,2001,89,107,127,108.84204541102,38
1044,2002,78,92,118,99.6419301019584,40
1044,2003,82,96,110,98.6582571564365,28
1044,2004,81,102,130,108.772324753021,49
1044,2005,90,108,131,109.828318851116,41
1044,2006,83,102,120,105.779623607943,37
1044,2007,74,99,126,104.635863700601,52
1044,2008,83,104,133,106.338796010109,50
1044,2009,80,103,124,105.90771255717,44
1044,2011,81,100,127,106.380938418138,46
1044,2013,97,111,132,116.850773345914,35
1044,2014,80,103,121,104.390608303537,41
1044,2015,88,103,123,107.651035944294,35
1045,1999,87,100,123,107.309796095044,36
1045,2000,78,93,110,98.530741552858,32
1045,2001,89,99,120,106.614914572334,31
1045,2002,81,104,118,104.329860304311,37
1045,2003,82,96,118,100.873333235405,36
1045,2004,90,110,136,115.311709463953,46
1046,2006,84,119,154,120.186850154122,70
1046,2007,71,112,151,114.686032867101,80
1046,2008,78,120,151,122.885013327655,73
1046,2009,78,127,156,123.629056021944,78
1047,1997,85,116,144,117.104929941249,59
1047,1998,95,124,144,125.026187147362,49
1047,1999,86,99,133,110.485462402866,47
1047,2000,85,118,144,119.449761919943,59
1048,1989,81,95,116,99.3719905334578,35
1048,1990,81,103,122,106.568413275065,41
1048,1991,93,114,136,117.856515775022,43
1048,1992,86,103,126,106.850336108962,40
1048,1993,88,102,123,109.506254205373,35
1048,1994,91,109,131,111.020647450282,40
1048,1995,71,97,118,101.003798243654,47
1048,1996,95,115,138,118.119211187477,43
1048,1997,98,112,123,113.969005339672,25
1048,1998,91,111,126,112.203005220134,35
1048,1999,86,103,124,108.109907083925,38
1048,2000,98,117,133,116.85265745672,35
1049,1995,82,102,116,103.873526036864,34
1049,1996,74,116,158,116.106136960973,84
1049,1997,74,107,151,112.114699884817,77
1049,2001,85,99,126,104.641828039264,41
1049,2002,91,118,143,115.406763186711,52
1049,2003,78,105,133,106.176532712018,55
1049,2004,81,112,137,112.720746441263,56
1049,2005,85,112,134,115.036582457495,49
1049,2006,85,103,132,108.626421995953,47
1049,2007,78,107,133,111.395875715788,55
1049,2008,84,107,130,111.740460492701,46
1049,2009,79,100,133,105.603355041311,54
1049,2011,72,101,141,110.238488723765,69
1049,2013,88,109,130,112.663106339069,42
1049,2014,90,106,122,108.964444639825,32
1049,2015,82,92,120,103.467390790898,38
1050,2001,91,105,123,110.315504967795,32
1050,2002,88,112,129,114.348736631792,41
1050,2004,81,102,123,104.058849896912,42
1050,2005,87,100,114,104.814625727639,27
1050,2006,81,95,107,101.198123942817,26
1050,2007,77,92,126,101.502265531855,49
1050,2008,91,111,132,112.582278215051,41
1050,2009,75,96,109,97.4534995034838,34
1050,2011,65,94,121,96.2167174802808,56
1050,2013,95,105,119,108.802067751318,24
1050,2014,74,90,111,97.0990703281338,37
1050,2015,82,95,116,100.238966101999,34
1051,2006,90,102,121,106.837479039884,31
1051,2007,71,102,122,101.568964176175,51
1051,2008,87,106,117,107.929258476264,30
1051,2009,75,93,113,98.6591118606645,38
1051,2011,80,94,124,102.620910481481,44
1051,2013,96,112,128,115.49632272204,32
1051,2014,91,100,126,105.497429133132,35
1051,2015,86,101,116,104.929327844197,30
1052,1993,87,99,123,105.366836827185,36
1052,1994,93,108,121,109.637868173921,28
1052,1995,79,94,115,99.2789271920112,36
1052,1996,98,108,130,112.269454816081,32
1052,1997,71,96,116,99.396449674878,45
1052,1998,88,99,115,104.333378526465,27
1052,1999,86,99,116,104.212264378362,30
1052,2000,80,105,127,107.39714688246,47
1052,2001,88,111,137,115.501741541407,49
1052,2002,85,113,134,114.664429247265,49
1052,2003,83,100,124,102.886549450948,41
1052,2004,79,97,120,103.60854090842,41
1052,2005,80,101,119,103.767955774922,39
1052,2006,81,95,116,103.633493086241,35
1052,2007,70,97,121,98.3624148316247,51
1052,2008,38,88,139,91.9811713657642,101
1054,2006,78,94,113,99.366336608785,35
1054,2007,78,100,121,104.01980195672,43
1054,2008,78,102,128,105.68208091392,50
1054,2009,78,92,121,101.723404259294,43
1054,2011,74,92,120,99.8333333330448,46
1054,2013,97,111,134,117.030827359963,37
1054,2014,85,106,134,111.936526235216,49
1054,2015,85,108,120,109.091674295976,35
1055,2005,81,102,125,106.252999814245,44
1055,2006,79,95,115,101.233997686759,36
1055,2007,73,98,126,101.963606733297,53
1055,2008,81,105,113,102.190422927793,32
1055,2009,75,93,116,96.7772719915834,41
1055,2011,77,87,102,92.6096720696321,25
1055,2013,106,117,124,119.086937639267,18
1055,2014,78,85,109,94.1394068031841,31
1055,2015,82,100,114,100.443320743764,32
1057,2001,95,123,144,124.249572692336,49
1057,2008,95,123,151,125.653024035234,56
1057,2009,85,102,153,114.898591683537,68
1057,2011,87,122,158,124.843535359441,71
1057,2013,95,117,137,118.423495273224,42
1057,2014,81,103,129,108.31995711961,48
1057,2015,80,102,137,111.567866487293,57
1058,1989,88,109,137,114.978952175745,49
1058,1990,97,117,137,120.783598259408,40
1058,1991,111,130,147,131.23776088891,36
1058,1992,95,119,137,120.292211307396,42
1058,1993,102,116,137,122.971336762269,35
1058,1994,103,114,137,119.11685718528,34
1058,1995,92,112,138,116.613235371111,46
1058,2001,92,118,136,118.141778258328,44
1058,2002,105,126,146,126.999282564151,41
1058,2003,89,110,137,113.198649381595,48
1058,2004,88,114,136,117.10025954289,48
1058,2005,88,107,137,113.944923954922,49
1058,2006,88,109,130,113.206756608517,42
1058,2007,81,102,130,108.490744531597,49
1058,2008,85,109,130,109.499268659764,45
1058,2009,85,109,151,117.125184293319,66
1058,2011,81,109,137,112.223782906662,56
1058,2013,74,117,151,116.313883918125,77
1058,2014,88,108,130,109.433038262579,42
1058,2015,86,109,144,116.172265036131,58
1059,1997,101,119,136,121.809243383139,35
1059,2001,94,132,159,131.37662026489,65
1059,2002,112,127,150,133.811707005248,38
1059,2003,94,124,145,125.720999880553,51
1059,2004,88,122,165,126.82756318563,77
1059,2005,102,128,152,130.809563305666,50
1059,2006,87,111,147,117.622831610669,60
1059,2007,81,109,131,110.52931401289,50
1060,2000,95,106,127,112.043554517101,32
1060,2001,91,105,123,110.538143847071,32
1060,2002,88,112,130,112.511732861583,42
1060,2003,89,102,125,106.967093819472,36
1060,2004,88,108,123,111.626062075023,35
1060,2005,87,101,122,107.714344269315,35
1060,2006,88,102,114,104.188953720986,26
1060,2007,78,95,109,98.1468533711386,31
1060,2008,88,104,125,108.349672764133,37
1060,2009,82,96,116,100.310615162502,34
1060,2011,88,102,122,107.431223982674,34
1060,2013,102,109,113,110.053380790596,11
1060,2014,78,92,124,99.4646358950716,46
1060,2015,85,100,134,110.927419343599,49
1063,2006,78,93,127,102.055648577777,49
1063,2007,64,95,127,99.2839093392199,63
1063,2008,72,104,137,104.393505893035,65
1063,2009,73,93,129,102.187924185435,56
1063,2011,65,92,127,97.8225138499556,62
1063,2013,92,117,141,119.38851110629,49
1063,2014,74,109,129,108.053145696905,55
1063,2015,79,95,129,104.530948454832,50
1064,2006,89,115,134,115.221909084818,45
1064,2007,74,98,119,101.58405358696,45
1064,2008,83,101,128,106.086273600007,45
1064,2009,82,103,129,106.378831789802,47
1064,2011,65,87,116,94.3400985849706,51
1064,2013,89,113,134,115.340181808391,45
1065,1995,86,110,120,108.797478906106,34
1065,1996,95,112,122,115.138003137217,27
1065,1997,78,100,120,103.120483092034,42
1065,1998,89,109,128,113.740022108301,39
1065,1999,88,107,123,108.157209995104,35
1065,2000,86,109,131,110.422515629889,45
1065,2001,85,102,121,106.15305051013,36
1065,2002,85,107,126,109.124907250852,41
1065,2003,81,102,118,104.022083333025,37
1065,2004,80,97,114,100.052383490837,34
1065,2005,90,102,113,104.645015199743,23
1065,2007,81,102,123,103.847841683631,42
1065,2008,78,105,123,104.026482032441,45
1065,2009,80,101,119,101.56011355678,39
1065,2011,74,96,115,100.50168581309,41
1065,2013,103,110,124,115.737118807354,21
1065,2014,81,101,118,106.526844334808,37
1065,2015,91,101,116,103.690313763553,25
1067,1988,82,92,116,98.8286616679467,34
1067,1989,39,84,123,88.858938841737,84
1067,1990,76,90,109,94.3717145591675,33
1067,1991,89,109,131,114.034730461718,42
1067,1992,74,87,102,93.8440786920777,28
1067,1993,78,93,128,104.177546678739,50
1067,1994,78,99,127,105.695712549298,49
1067,1995,84,91,126,101.874767555729,42
1067,1996,96,110,134,116.354831820211,38
1067,1997,74,95,123,100.923889923387,49
1067,1998,90,101,129,107.7703357284,39
1067,1999,79,107,127,108.337786673452,48
1067,2000,89,109,131,113.17311377704,42
1067,2001,88,111,136,113.610030357259,48
1067,2002,79,108,135,112.991906175548,56
1067,2003,81,99,134,106.600463885786,53
1067,2006,76,98,126,102.877534581489,50
1067,2007,74,101,139,107.040665428933,65
1067,2008,81,106,144,113.051509541115,63
1067,2011,69,116,153,113.694248182571,84
1067,2013,95,123,157,127.793602157533,62
1067,2014,78,100,137,107.340420479657,59
1067,2015,76,85,144,103.626312012226,68
1068,2004,81,97,110,101.173396513842,29
1070,1997,90,110,124,110.612959550788,34
1070,1998,80,102,137,111.227095636418,57
1070,1999,87,101,121,108.079495410106,34
1070,2000,80,102,123,108.069673587589,43
1070,2001,88,99,123,107.547700990803,35
1070,2002,86,107,123,108.557013130269,37
1070,2003,68,95,117,95.2979394013916,49
1070,2004,82,108,132,110.906942449027,50
1070,2005,84,99,113,101.920446100339,29
1070,2006,85,92,115,100.723372256716,30
1070,2007,71,94,115,98.6255777979195,44
1070,2008,81,102,137,108.397271698969,56
1070,2009,81,99,130,106.453301608357,49
1070,2011,64,92,130,98.8402615722787,66
1070,2013,92,106,135,113.93150364283,43
1070,2014,78,92,127,99.9410889829693,49
1070,2015,85,102,121,105.783250851049,36
1073,2001,89,105,126,107.633936091653,37
1073,2002,80,105,138,109.285429872297,58
1073,2003,82,101,124,108.5237528973,42
1073,2004,97,115,144,120.948264470636,47
1073,2005,90,102,124,108.088876757013,34
1073,2006,90,105,121,106.521295167792,31
1073,2007,80,94,113,100.292593696492,33
1073,2008,91,118,145,120.650651901965,54
1073,2009,84,96,122,102.800280887751,38
1074,2001,81,105,119,103.634681513101,38
1074,2002,86,108,135,113.898974040812,49
1074,2003,87,102,124,110.214630593299,37
1074,2004,97,116,137,120.410448923798,40
1074,2005,89,105,130,111.407060947013,41
1074,2006,90,102,123,108.740169109916,33
1074,2007,95,116,151,121.739770356208,56
1074,2009,84,105,145,114.908871127073,61
1074,2011,98,124,154,126.087584270303,56
1074,2014,74,116,158,120.824419985755,84
1074,2015,102,116,130,120.134414749879,28
1075,2001,84,103,135,108.005905486719,51
1075,2002,85,106,143,115.11283184936,58
1075,2004,75,116,136,113.612179422648,61
1075,2005,82,103,131,108.146341411943,49
1075,2006,78,92,115,100.601830658358,37
1075,2007,74,89,115,96.0300058534628,41
1075,2008,84,101,130,106.074190733774,46
1075,2009,74,93,116,96.9378975589835,42
1075,2013,90,103,131,109.479695954559,41
1075,2015,77,95,123,100.843901546023,46
1076,2001,85,105,126,108.124999945275,41
1076,2002,92,117,127,114.631578945492,35
1076,2003,90,106,129,111.853658553386,39
1076,2004,86,114,127,113.222222208115,41
1076,2005,88,108,131,110.666666671714,43
1076,2006,91,99,127,105.838235355539,36
1076,2007,74,99,136,108.221626406293,62
1076,2008,83,92,114,99.577611064074,31
1076,2009,84,105,122,106.882224315414,38
1076,2011,74,111,138,109.769842755724,64
1077,2001,85,106,127,111.382978700336,42
1077,2002,97,106,127,113.962025325492,30
1077,2004,79,101,127,108.54929570732,48
1079,2001,84,106,135,110.678571331537,51
1079,2002,97,118,137,119.571428540312,40
1081,2000,87,110,127,108.959222318795,40
1081,2001,91,106,127,110.299247490713,36
1081,2002,87,106,128,111.719834338792,41
1081,2003,82,100,124,105.850202200374,42
1081,2004,88,101,122,107.263851809751,34
1081,2005,88,106,130,110.564024387858,42
1081,2006,85,102,120,104.843387886823,35
1081,2007,78,102,122,105.867731867601,44
1081,2008,86,104,121,104.083957996074,35
1081,2009,82,101,116,101.743062823484,34
1081,2011,81,93,115,100.222932349675,34
1081,2013,97,104,123,110.192759472595,26
1081,2014,73,85,115,95.9621539949972,42
1081,2015,81,94,117,100.807036372061,36
1083,2000,87,107,137,113.603603603581,50
1083,2001,86,106,127,110.56451359463,41
1083,2002,86,113,135,118.301989156455,49
1083,2003,84,110,127,109.032702221647,43
1083,2004,89,114,135,116.057429451433,46
1083,2005,87,106,134,115.326373540003,47
1083,2006,85,106,134,113.240776654938,49
1083,2007,71,97,127,103.052606453545,56
1083,2008,84,102,136,109.861839963955,52
1083,2009,80,100,135,106.721777964829,55
1083,2011,72,93,137,104.632893629222,65
1083,2013,96,107,128,112.466013346269,32
1083,2014,79,100,128,104.21872372172,49
1083,2015,79,100,122,104.716878504112,43
1084,1997,84,99,130,104.812843528583,46
1084,2000,88,109,144,115.338495945789,56
1084,2001,97,122,149,125.563574670896,52
1084,2002,101,129,151,132.173739373266,50
1084,2013,95,107,137,113.873505016362,42
1084,2014,74,108,144,111.78316334656,70
1085,2002,88,104,130,110.664735148622,42
1085,2003,82,101,124,103.391863478487,42
1085,2004,85,115,129,114.254194251313,44
1085,2005,79,105,117,102.90101784914,38
1085,2006,84,97,118,99.765109858273,34
1085,2007,70,91,126,97.8697741200448,56
1085,2008,87,109,128,110.420594181546,41
1085,2009,74,92,116,95.5627651506486,42
1086,2006,87,116,144,116.474906441152,57
1086,2007,81,99,130,108.876021202313,49
1087,2006,87,106,128,109.790788692732,41
1087,2007,99,116,123,116.740231744186,24
1089,2001,93,117,136,119.591990974881,43
1089,2002,95,116,143,122.955913159588,48
1089,2003,85,109,136,114.85133145451,51
1089,2005,97,109,130,113.892473111958,33
1089,2006,90,109,137,113.130307794655,47
1089,2007,65,103,137,104.127547628238,72
1089,2008,46,95,144,99.5769153535068,98
1089,2009,69,90,121,97.2440307942966,52
1089,2011,84,109,137,111.684902611498,53
1089,2013,94,113,134,118.490031175621,40
1089,2014,73,92,116,99.0716398902978,43
1089,2015,87,106,121,109.372131198638,34
1090,2003,81,85,110,95.4947548187749,29
1090,2004,75,97,124,102.832434568818,49
1090,2005,80,101,122,102.873446823892,42
1090,2006,78,92,107,98.778867639869,29
1090,2007,69,96,113,96.6831726890431,44
1090,2008,81,95,123,102.758058393862,42
1090,2009,74,89,104,92.0844537977304,30
1090,2011,75,87,106,94.401960849113,31
1090,2013,66,100,144,106.266572989833,78
1090,2014,78,88,122,98.9746498551702,44
1090,2015,80,97,120,101.401960759383,40
1091,2005,88,108,134,112.032639901206,46
1091,2006,85,92,130,104.898666992143,45
1091,2007,83,109,147,113.448763237959,64
1091,2008,83,114,136,116.546655324921,53
1091,2013,96,110,117,110.283069567447,21
1093,2004,119,129,154,135.752238942231,35
1093,2005,106,134,155,134.942761310577,49
1093,2006,92,128,166,130.212227454367,74
1093,2007,115,139,168,143.735459262933,53
1093,2008,102,130,158,134.598660277314,56
1093,2009,95,136,161,134.801200429622,66
1093,2011,102,137,168,139.65185078123,66
1093,2013,108,137,157,139.244627733117,49
1093,2014,93,120,144,126.004769872984,51
1093,2015,101,138,165,137.72279078087,64
1094,2003,89,102,127,109.102007491447,38
1094,2006,79,103,126,102.745443341049,47
1094,2007,71,104,127,106.125044973718,56
1094,2008,61,102,144,105.153400920164,83
1094,2009,75,103,130,104.313227563862,55
1094,2011,63,106,144,105.885673486102,81
1094,2013,90,102,123,108.093725848268,33
1094,2014,88,99,125,105.147525119933,37
1094,2015,87,116,137,117.546454019565,50
1095,2003,81,106,137,112.477140207655,56
1095,2006,85,109,129,111.931358044307,44
1095,2007,73,106,141,111.470174757372,68
1095,2008,84,111,145,115.957462332648,61
1095,2009,82,103,141,107.557834158507,59
1095,2011,55,110,168,111.462600710294,113
1095,2013,104,113,142,122.343703999293,38
1095,2014,80,114,128,114.126133417615,48
1095,2015,88,107,134,112.74355340854,46
1096,2000,81,95,116,100.788424034111,35
1096,2002,79,117,151,119.23175195952,72
1098,2003,81,102,116,102.810134515527,35
1098,2006,90,103,123,107.097800189458,33
1098,2007,69,88,128,97.4482991346419,59
1098,2008,88,112,137,112.358074755055,49
1098,2009,76,101,136,104.54705901803,60
1098,2011,81,102,132,106.773387674908,51
1098,2013,96,112,147,119.041054467603,51
1098,2014,102,113,123,116.049729808875,21
1098,2015,94,109,130,112.879722794544,36
1099,2003,62,78,109,88.7410558043294,47
1099,2006,78,95,132,106.629552455927,54
1099,2007,74,102,130,105.504691539455,56
1099,2008,84,109,130,112.458962031859,46
1099,2009,94,111,133,112.762035358449,39
1099,2011,67,101,136,105.163147655437,69
1099,2013,77,116,148,116.343698710501,71
1099,2014,78,102,122,107.688254255477,44
1099,2015,81,105,120,106.156856497349,39
1100,1982,91,109,127,112.677707619882,36
1100,1983,95,107,127,110.833898020911,32
1100,1984,87,99,124,108.026207130768,37
1100,1985,94,115,139,120.986226359963,45
1100,1986,92,107,137,116.415174728356,45
1100,1987,93,108,135,113.963661480514,42
1100,1988,84,103,123,104.973116593867,39
1100,1989,88,102,121,104.415905731987,33
1100,1990,86,109,130,110.966386947975,44
1100,1991,95,111,130,117.291541019964,35
1100,1992,80,96,113,98.3786600118883,33
1101,2002,102,117,139,120.398467432953,37
1101,2003,86,103,121,107.245140383617,35
1101,2004,89,109,121,110.575443781368,32
1101,2005,98,107,129,113.027975021326,31
1101,2006,92,105,120,108.807273410173,28
1101,2007,89,110,121,109.480074148532,32
1101,2008,85,111,129,112.741747559475,44
1101,2009,92,101,124,109.756715534434,32
1101,2011,88,106,120,108.318377599342,32
1101,2013,96,108,128,112.736465366829,32
1101,2014,85,100,122,104.175408873393,37
1101,2015,100,114,129,116.72938688411,29
1102,2002,92,113,141,118.700916311242,49
1102,2003,78,99,127,103.898367478656,49
1102,2004,88,112,132,112.843939841564,44
1102,2005,88,112,132,113.087535380862,44
1102,2006,91,105,120,106.787180371768,29
1102,2007,90,109,134,114.116963842198,44
1102,2008,91,109,137,112.058927971798,46
1102,2009,88,101,123,106.926634883169,35
1102,2011,84,100,123,105.102952537711,39
1102,2013,98,109,131,115.545860181171,33
1102,2014,71,97,116,97.8391001827314,45
1102,2015,94,109,130,114.641534713494,36
1103,2002,95,118,144,122.524686134397,49
1103,2003,87,105,127,110.434387736519,40
1103,2004,116,123,130,126.538972960102,14
1103,2005,79,116,143,116.64390866264,64
1103,2006,90,102,116,102.860429908083,26
1103,2007,95,107,122,111.177272822535,27
1103,2008,81,124,165,125.819137345113,84
1103,2009,86,105,128,110.919949412482,42
1103,2011,88,112,127,113.340646633063,39
1103,2013,99,113,129,118.679279367173,30
1103,2014,90,108,123,110.823986970401,33
1103,2015,94,119,135,120.458514177135,41
1105,2002,78,116,144,117.081531312329,66
1105,2003,85,100,130,109.992859066184,45
1105,2005,67,109,151,111.410201920146,84
1105,2006,96,105,113,105.555304620607,17
1105,2007,62,100,137,102.51610763402,75
1106,2000,88,106,137,114.422019774211,49
1106,2002,107,120,141,123.677320447508,34
1106,2003,63,104,130,105.636706964729,67
1106,2004,96,116,130,118.978946256462,34
1106,2005,95,107,133,113.883474780194,38
1106,2006,93,109,123,108.767788231524,30
1106,2007,88,109,127,110.557528841306,39
1106,2009,69,109,151,112.343145705298,82
1106,2011,83,100,116,103.756845652981,33
1106,2013,88,111,125,110.218130381716,37
1106,2014,86,102,113,103.32817638857,27
1106,2015,87,101,128,106.39582755002,41
1107,1994,88,124,158,126.304872813353,70
1107,1995,93,112,125,111.645462936503,32
1107,1996,97,113,134,119.368665744103,37
1107,1997,97,110,124,109.901045386138,27
1107,1998,92,107,131,112.6481568108,39
1107,1999,85,110,126,112.197570573753,41
1107,2000,86,107,123,109.502407358094,37
1107,2001,86,107,121,111.341038830454,35
1107,2002,101,119,137,119.99621060125,36
1107,2003,86,106,121,108.030036512458,35
1107,2004,86,108,128,111.564285723341,42
1107,2005,92,107,128,114.402942765204,36
1107,2006,90,106,120,107.025787955743,30
1107,2007,90,106,127,112.081336467606,37
1107,2008,91,112,130,116.283462181245,39
1107,2009,85,102,123,108.557953272449,38
1107,2011,87,103,125,107.486758873369,38
1107,2013,100,108,129,113.996478875059,29
1107,2014,85,100,116,103.353211007606,31
1107,2015,92,115,134,117.093429601295,42
1108,1997,95,113,127,115.626405870333,32
1108,1998,85,99,113,101.400912506843,28
1108,1999,43,85,134,91.4874977722574,91
1108,2000,85,109,120,107.990401035165,35
1108,2001,85,106,121,109.886120148876,36
1108,2002,94,116,137,117.148380927953,43
1108,2003,83,94,121,102.374575774,38
1108,2004,81,97,126,105.24837873943,45
1108,2005,87,109,129,113.683991447509,42
1108,2006,88,105,119,105.483845854495,31
1108,2007,88,105,121,107.058761998524,33
1108,2008,81,112,129,110.172508791214,48
1108,2009,88,102,122,107.800931937584,34
1108,2013,96,109,123,114.715762246083,27
1108,2014,90,105,122,109.143120490062,32
1108,2015,88,109,135,115.573808781529,47
1110,1998,90,103,127,108.787624502701,37
1110,1999,86,100,121,107.418335010587,35
1110,2000,88,108,128,109.668938463899,40
1110,2001,94,109,121,112.75804585496,27
1110,2002,95,116,137,116.391543401603,42
1110,2003,81,100,117,103.650222789595,36
1110,2004,86,104,122,106.877807886784,36
1110,2005,89,100,121,107.706592220615,32
1110,2006,88,104,116,104.472237468587,28
1110,2007,95,109,123,110.560757126586,28
1110,2008,91,111,130,113.586920579726,39
1110,2009,83,100,124,105.318758808769,41
1111,1989,90,102,114,103.982073696963,24
1111,1990,86,104,123,106.769450768097,37
1111,1991,96,111,130,114.958968739933,34
1111,1992,84,93,119,98.5997284910522,35
1111,1994,102,119,128,121.644678611827,26
1111,1995,95,106,120,111.474936261127,25
1111,1996,101,113,135,122.221183086203,34
1111,1997,88,107,130,113.030027155049,42
1111,1998,88,100,133,109.183849377593,45
1111,1999,88,99,120,107.605339398821,32
1111,2000,81,104,130,107.158646500987,49
1111,2002,97,117,134,121.00798808387,37
1111,2003,86,106,120,107.188552344873,34
1111,2004,83,104,123,107.705882342766,40
1111,2005,89,107,130,113.11580500425,41
1111,2006,78,105,126,105.054569707584,48
1111,2007,88,109,131,114.644847995212,43
1111,2008,81,112,129,110.884435101014,48
1111,2009,87,105,123,108.216953012785,36
1111,2011,88,102,127,108.978597165121,39
1111,2013,96,113,130,116.374543896179,34
1111,2014,78,100,126,104.427467449515,48
1111,2015,94,109,130,114.241535119838,36
1112,2002,104,117,138,119.286243672087,34
1112,2003,85,100,117,105.799364237474,32
1112,2004,91,104,123,108.180363141547,32
1112,2005,92,112,123,110.023117524448,31
1112,2006,90,101,123,106.343299674215,33
1112,2007,88,107,120,108.40642203664,32
1112,2008,91,109,130,112.066859385217,39
1112,2009,87,101,122,108.065859716571,35
1113,1990,93,108,122,111.745135626828,29
1113,1991,98,113,127,114.362656489326,29
1113,1992,86,96,115,101.828888111083,29
1113,1993,90,104,123,109.497246216535,33
1113,1994,104,118,128,118.120021172943,24
1113,1995,92,111,121,111.667579124941,29
1113,1996,96,113,127,115.502223858867,31
1113,1997,98,108,120,111.051416549393,22
1113,1998,93,107,131,111.406585833173,38
1113,1999,97,101,120,108.765065969857,23
1113,2000,88,108,121,110.910006689993,33
1113,2001,93,107,130,113.986139039,37
1113,2002,101,125,138,123.585352469285,37
1113,2003,85,107,128,109.606552444611,43
1113,2004,88,107,121,109.192158724501,33
1113,2006,94,102,136,111.230571142261,42
1113,2007,88,100,122,108.72746390965,34
1113,2008,92,115,137,120.492528281516,45
1113,2009,86,101,124,106.463712787499,38
1113,2011,88,105,125,107.663863545968,37
1113,2013,99,113,129,115.723541894846,30
1113,2014,91,95,109,102.349172146927,18
1113,2015,94,106,122,111.693452891535,28
1114,1998,67,101,146,108.188091407993,79
1114,2000,88,101,125,107.485778398134,37
1114,2002,98,116,138,118.403764147902,40
1114,2003,86,104,123,106.244925485091,37
1114,2004,83,104,123,106.752343988244,40
1114,2005,81,116,158,121.927731056272,77
1114,2006,90,102,123,109.49406716263,33
1114,2007,80,109,132,108.336886206443,52
1114,2008,83,104,130,107.259347955069,47
1114,2009,85,110,130,111.764554014106,45
1114,2011,89,109,120,108.832592798299,31
1114,2013,99,113,137,120.807398730661,38
1114,2014,88,103,116,108.815714269545,28
1114,2015,94,107,121,111.38586701899,27
1115,1995,88,103,124,110.048943819654,36
1115,1996,103,116,131,119.789625596846,28
1115,1997,96,111,120,111.903004298983,24
1115,1998,93,107,133,113.582412609274,40
1115,1999,95,112,130,113.56655780534,35
1115,2000,88,109,130,112.065063292605,42
1115,2001,93,107,127,112.560312914059,34
1115,2002,101,125,134,122.156488548392,33
1115,2003,86,106,121,108.233141452757,35
1115,2004,86,109,127,110.428609138611,41
1115,2005,94,107,123,111.114057446404,29
1115,2006,94,108,121,109.980707299521,27
1115,2007,89,106,127,108.712449608249,38
1115,2008,92,111,130,113.921764984103,38
1115,2009,109,123,137,123.736787517368,28
1115,2011,89,102,127,108.548940931835,38
1115,2013,102,116,129,116.869690101066,27
1115,2014,78,102,113,103.105803516682,35
1115,2015,95,106,134,115.853575065027,39
1116,1985,109,109,116,115.735478414776,7
1116,1986,97,116,136,121.497554185292,39
1116,1987,109,128,150,133.984245621078,41
1116,1988,102,106,106,106.587273388412,4
1116,1990,53,107,151,108.794201215163,98
1116,1991,95,117,135,119.472180978485,40
1116,1992,85,108,120,110.549496881276,35
1116,1993,85,116,154,122.196280169602,69
1116,1994,103,118,140,121.002911961451,37
1116,1995,95,110,125,114.344655954668,30
1116,1996,96,109,130,116.233094931307,34
1116,1997,109,123,127,123.498627933868,18
1116,1999,67,115,163,120.834211879944,96
1116,2000,60,108,157,114.599397393956,97
1116,2002,89,118,139,116.324987519146,50
1116,2003,81,106,124,108.315420710967,43
1116,2004,95,130,158,131.080870480249,63
1116,2005,81,116,158,121.021957620562,77
1116,2006,109,116,123,119.446119327511,14
1116,2007,84,111,137,113.013384587226,53
1117,1997,95,108,120,112.650647591963,25
1117,1998,60,99,144,103.77781966426,84
1117,2000,39,80,130,83.4198956533667,91
1117,2001,100,107,117,111.125011129121,17
1117,2002,109,123,137,125.038718895746,28
1117,2003,77,107,151,112.977546166395,74
1117,2004,75,112,144,111.305003331572,69
1117,2005,68,109,151,111.694582164989,83
1117,2006,95,115,137,120.227730755177,42
1117,2007,102,108,115,111.033274448135,13
1117,2008,81,112,144,116.633931382904,63
1117,2009,63,102,151,106.098430889736,88
1117,2011,36,81,130,85.083018641179,94
1118,2001,93,106,116,109.98354669628,23
1118,2002,98,116,138,120.076102985814,40
1118,2003,89,100,118,103.885803095781,29
1118,2004,88,106,130,113.296277735026,42
1118,2005,98,109,124,110.572362053113,26
1118,2006,90,105,116,108.732576870457,26
1118,2007,88,99,130,109.787329683052,42
1118,2008,69,111,151,113.525399274128,82
1118,2009,90,101,124,106.199231797057,34
1118,2011,81,95,124,104.79428570687,43
1118,2013,87,110,131,114.177218224066,44
1118,2014,79,98,115,101.403762600718,36
1118,2015,87,94,121,102.052238801956,34
1119,1995,92,111,122,114.041717613438,30
1119,1996,108,118,144,126.706668623332,36
1119,1997,97,111,124,114.226686185984,27
1119,1998,95,107,131,113.03436135093,36
1119,1999,87,110,130,112.062613300391,43
1119,2000,92,107,133,112.925945767858,41
1119,2002,88,119,144,119.619298723661,56
1119,2003,90,104,125,108.928143048669,35
1119,2004,95,116,137,119.917697273776,42
1119,2005,94,108,122,112.450678445592,28
1119,2006,88,102,113,105.225040142205,25
1119,2007,83,99,123,106.880359174387,40
1119,2011,89,112,121,112.764063105168,32
1119,2013,99,113,129,116.375105993048,30
1119,2014,85,102,113,102.893668838912,28
1119,2015,98,116,139,120.037513086195,41
1121,1980,104,122,145,127.153255525132,41
1121,1981,109,125,147,129.399630321255,38
1121,1989,87,109,127,111.819392850241,40
1121,1990,94,111,132,116.648015146544,38
1121,1991,101,117,135,120.45444294203,34
1121,1993,93,116,142,119.892334427221,49
1121,1994,104,117,137,122.815941681012,33
1121,1995,101,117,130,118.922875382785,29
1121,1996,103,118,138,122.650157599051,35
1121,1997,103,117,131,118.534500483668,28
1122,1994,81,108,143,114.441261888319,62
1122,2001,93,107,124,110.176211807747,31
1122,2002,98,116,134,119.365854920825,36
1122,2003,86,105,126,105.899935520217,40
1122,2004,86,104,124,106.898187070295,38
1122,2005,88,102,124,109.01123688644,36
1122,2006,90,105,126,107.735135812803,36
1122,2007,87,99,121,106.505451677579,34
1122,2008,91,112,130,114.655466840979,39
1122,2009,87,105,125,110.404340212254,38
1122,2011,87,105,125,110.140644240608,38
1122,2013,100,107,130,115.009183585539,30
1122,2014,78,100,113,103.644822627826,35
1122,2015,95,116,129,115.686500750924,34
1123,1997,97,108,125,110.944450698328,28
1123,2002,98,127,165,134.340053606824,67
1123,2003,81,98,116,103.581928664277,35
1123,2005,88,109,122,109.62403151095,34
1123,2006,86,102,118,104.339727778373,32
1123,2007,74,109,151,113.493172473886,77
1123,2008,65,109,151,114.586565720817,86
1123,2009,86,104,128,111.001202862956,42
1123,2013,96,110,121,112.439175677624,25
1123,2015,88,109,133,113.063980681443,45
1124,2002,102,119,134,121.19857929426,32
1124,2003,82,104,124,107.545463970884,42
1124,2004,83,104,123,105.002806643725,40
1124,2005,94,111,128,112.614102164575,34
1124,2007,88,101,116,103.336606453619,28
1124,2008,92,112,123,112.597830123321,31
1124,2009,81,109,144,113.361187459103,63
1124,2011,88,112,137,115.452345475878,49
1124,2015,95,109,129,114.667098613705,34
1125,1998,93,101,123,107.418570737258,30
1125,1999,85,102,120,106.804101937793,35
1125,2000,87,103,121,107.300705621695,34
1125,2001,85,111,133,113.53224235962,48
1125,2002,97,109,134,114.820610694982,37
1125,2003,82,95,117,100.458100540048,35
1125,2004,78,85,106,93.4472920749549,28
1125,2005,87,100,120,109.688998284628,33
1125,2008,91,109,124,109.891798645947,33
1125,2009,83,93,116,102.273027319008,33
1125,2011,88,100,129,108.840974761678,41
1125,2013,97,104,116,110.091938903008,19
1125,2014,76,96,116,99.0358333407585,40
1125,2015,95,109,130,115.400739573672,35
1126,1997,96,108,120,110.64467064122,24
1126,1998,92,107,123,109.393483970626,31
1126,1999,86,99,113,105.127569726949,27
1126,2000,88,102,120,107.161016942233,32
1126,2001,93,107,114,108.116776014769,21
1126,2002,98,107,127,113.979166656552,29
1126,2003,82,94,106,98.5525525497647,24
1126,2004,86,104,120,107.507214550034,34
1126,2005,87,107,123,106.968303986413,36
1126,2006,90,104,113,104.210233390111,23
1126,2007,87,100,122,105.881880744646,35
1126,2008,91,111,126,110.771522459667,35
1126,2009,86,101,116,105.37665381731,30
1126,2011,88,103,121,108.097676989032,33
1126,2013,100,107,121,113.059242016846,21
1126,2014,78,93,113,99.0869594157379,35
1126,2015,90,108,123,110.996768939175,33
1127,2002,96,117,138,118.453125009825,42
1127,2003,82,94,126,104.582887746216,44
1127,2004,82,104,128,108.827120843425,46
1127,2005,85,110,129,110.281409644303,44
1127,2007,81,102,123,102.972779557857,42
1127,2008,81,104,123,105.963716140462,42
1127,2009,88,110,125,110.124606382132,37
1127,2011,89,104,130,110.756764137859,41
1127,2015,95,109,129,115.993073400537,34
1129,1990,88,109,122,109.948806100923,34
1129,1991,105,115,130,118.412722150765,25
1129,1992,90,101,123,108.83313714352,33
1129,1996,110,116,130,121.17636512744,20
1129,1997,112,116,134,122.813219932324,22
1129,1998,102,124,140,123.783531149615,38
1129,1999,109,130,144,131.694123202384,35
1129,2000,90,109,130,113.215431622424,40
1129,2001,93,107,127,112.615226546414,34
1131,1998,87,109,131,114.546552173754,44
1131,1999,88,106,128,112.161976208217,40
1132,2011,72,102,137,108.272548081505,65
1132,2013,86,102,130,109.765052087924,44
1132,2014,73,94,120,101.188462603883,47
1132,2015,85,107,123,109.581448707911,38
1134,1998,95,116,131,118.609493461807,36
1134,1999,88,100,120,106.464458682237,32
1134,2000,88,109,130,112.596469796011,42
1134,2001,73,102,144,108.517128871261,71
1134,2002,73,118,158,118.678127208994,85
1134,2003,81,100,123,102.511416069614,42
1134,2015,100,106,130,114.536273122327,30
1136,1995,98,117,132,118.035398234424,34
1136,1996,102,110,131,117.739649031565,29
1136,1997,97,119,137,118.568355047577,40
1136,1998,92,124,140,122.007054034946,48
1136,1999,90,109,138,114.463762549514,48
1136,2000,89,108,133,113.927223276218,44
1136,2001,93,116,130,117.029067247153,37
1136,2002,97,117,142,121.776412359849,45
1136,2003,87,112,130,114.860015352289,43
1136,2004,89,104,122,108.516848398104,33
1136,2005,89,117,134,119.509950240063,45
1136,2006,84,105,126,105.789761736053,42
1136,2007,88,118,135,117.562894687535,47
1136,2008,102,126,135,126.097637152492,33
1136,2009,90,116,128,115.977760346461,38
1136,2011,89,118,139,115.434404538224,50
1138,2004,92,113,134,118.021801858571,42
1138,2005,91,109,131,113.889565065968,40
1138,2006,90,103,115,107.790909079329,25
1138,2007,95,130,151,127.304084179316,56
1139,2002,118,130,151,136.262890995631,33
1139,2003,98,107,128,115.983803965391,30
1140,2001,116,123,137,129.682108360778,21
1140,2002,67,113,158,114.959440863739,91
1140,2003,72,106,151,112.833331905739,79
1140,2004,96,112,123,112.115613080733,27
1140,2006,91,110,125,109.951446399991,34
1140,2011,89,105,109,102.690059401623,20
1140,2013,95,123,158,128.774020554686,63
1140,2014,91,108,126,109.618418875417,35
1141,2002,94,118,127,116.985848974223,33
1141,2003,85,103,121,107.303718632559,36
1141,2004,86,103,120,108.252491693749,34
1141,2005,88,107,124,109.419888424308,36
1141,2006,84,102,120,105.434949384533,36
1141,2007,90,106,130,110.875000007908,40
1141,2008,89,112,130,113.471321625195,41
1141,2011,85,109,121,107.312605833842,36
1141,2013,96,108,129,113.985465114385,33
1141,2014,86,99,113,101.62222219094,27
1141,2015,92,106,130,112.144050102301,38
1142,2002,107,123,143,125.855458288423,36
1142,2003,90,106,123,113.564211019491,33
1142,2004,96,119,137,119.603055370572,41
1142,2005,95,107,127,112.633980638122,32
1142,2006,92,109,130,112.825253236396,38
1142,2007,83,99,130,107.029499527221,47
1142,2008,101,112,137,118.392202426114,36
1142,2009,96,109,129,110.772728123971,33
1142,2011,88,106,120,109.618942002709,32
1142,2013,102,113,129,117.959684821659,27
1142,2014,79,102,122,104.340908388388,43
1142,2015,95,111,134,115.87960241427,39
1143,2002,95,118,134,119.410859924849,39
1143,2003,82,94,126,102.59463453052,44
1143,2004,82,104,123,105.858352612092,41
1143,2005,88,112,129,110.280408062259,41
1143,2006,88,108,120,108.013478548486,32
1143,2007,83,95,120,102.703103986329,37
1143,2008,88,109,130,110.88537952672,42
1143,2009,85,103,114,106.406536875749,29
1143,2011,88,102,120,107.777423406669,32
1143,2013,96,110,130,115.885586966998,34
1143,2014,78,101,113,100.976859502443,35
1143,2015,94,107,130,110.465555161275,36
1144,2003,86,100,125,107.715780455624,39
1144,2004,88,100,121,105.922981258425,33
1144,2005,87,99,122,107.245142094148,35
1144,2006,88,104,121,106.910928910509,33
1144,2007,88,100,113,105.048499100952,25
1144,2008,91,112,133,113.670974883992,42
1144,2009,85,100,115,104.540746690565,30
1144,2011,88,106,120,110.110416228705,32
1144,2013,98,108,121,111.999999712431,23
1144,2014,78,99,113,102.696944363206,35
1144,2015,95,107,130,113.369729948354,35
1145,2002,83,109,138,112.290735318564,55
1145,2003,71,100,137,106.909507468692,66
1145,2004,81,102,123,105.462927470666,42
1145,2005,94,108,122,110.540351812025,28
1145,2006,89,104,114,106.012729856426,25
1145,2007,88,99,116,106.854134303581,28
1145,2008,67,95,137,102.56386853501,70
1145,2009,81,102,133,107.657455535536,52
1145,2011,88,101,121,105.363077437861,33
1145,2013,97,109,123,111.878687603651,26
1145,2014,90,93,114,101.522352937841,24
1145,2015,94,109,130,114.273218237238,36
1146,2002,76,109,138,112.114338664487,62
1146,2003,82,95,121,102.108601119793,39
1146,2004,81,102,127,106.862505351784,46
1146,2005,91,108,123,109.799470118234,32
1146,2006,89,109,125,110.383503553603,36
1146,2007,88,99,120,104.460922943401,32
1146,2008,95,116,137,117.66560076361,42
1146,2009,88,101,127,108.972353488228,39
1146,2011,91,111,127,113.604640563506,36
1146,2013,96,113,130,115.737211578979,34
1146,2014,87,96,113,100.90485382399,26
1146,2015,91,107,132,109.14181876361,41
1147,1993,85,104,121,110.224945291435,36
1147,1994,96,110,129,114.682648821496,33
1147,1995,91,101,116,106.836668933618,25
1147,1996,100,116,134,121.726659459735,34
1147,1997,90,99,113,106.654353273702,23
1147,1999,86,103,117,105.408412539748,31
1147,2000,87,102,108,103.832937002745,21
1147,2001,95,104,122,110.500969924426,27
1147,2002,88,109,127,112.831129724298,39
1147,2003,82,95,117,100.981909178936,35
1147,2004,83,112,122,108.813373457802,39
1147,2005,92,112,130,112.927315796287,38
1147,2006,91,102,115,104.920829912953,24
1147,2007,98,107,130,114.463229278629,32
1147,2008,81,102,129,107.429925807606,48
1147,2009,85,100,116,104.438912748244,31
1147,2011,89,100,121,107.353505073753,32
1147,2013,96,107,130,113.145265242179,34
1147,2014,78,98,122,103.088675168216,44
1147,2015,91,106,130,113.354189627183,39
1148,2003,81,95,131,106.532580454456,50
1148,2004,68,81,95,85.269243829362,27
1148,2005,56,92,144,98.4291110660392,88
1149,2004,60,95,124,96.8549328758468,64
1149,2005,89,107,130,114.436244977551,41
1149,2006,88,104,123,109.959140146396,35
1149,2007,81,95,115,101.372136274946,34
1149,2008,84,104,123,108.045759120905,39
1149,2009,83,95,123,103.12871536257,40
1149,2011,88,110,127,110.9728714996,39
1149,2013,98,106,121,113.378835922019,23
1149,2014,82,105,121,104.998865792687,39
1149,2015,95,107,129,114.061964370848,34
1150,2005,88,102,123,109.295249237732,35
1150,2006,90,102,113,106.965631148277,23
1150,2007,87,110,122,109.467435544301,35
1150,2008,88,112,130,114.755683603974,42
1150,2009,83,95,124,103.095052660549,41
1150,2011,89,101,125,108.008432615183,36
1150,2014,80,93,115,101.353837333956,35
1150,2015,95,106,123,111.65679633544,28
1151,2002,105,116,130,120.42089939654,25
1151,2003,60,95,137,101.459186137214,77
1151,2006,88,105,129,110.164401667035,41
1151,2007,88,109,130,112.870653744681,42
1151,2008,95,112,130,113.149343020662,35
1151,2009,87,101,123,106.749489721342,36
1151,2011,81,103,125,106.73876014308,44
1151,2013,98,107,123,110.844965236794,25
1151,2014,79,93,106,97.382588001251,27
1151,2015,88,101,116,106.047677452566,28
1153,2006,88,105,125,105.198681911578,37
1153,2007,82,98,115,103.066854652648,33
1153,2008,88,109,120,108.650049183845,32
1153,2009,89,114,128,113.874188894904,39
1153,2011,88,101,127,110.954197995739,39
1153,2014,87,102,117,105.879035623767,30
1153,2015,94,106,129,113.433343895807,35
1155,2007,91,115,137,117.699231077768,46
1155,2009,86,106,126,108.983863959574,40
1156,2006,89,101,125,106.301318675409,36
1156,2007,79,107,134,110.339867267035,55
1157,2007,89,99,120,105.558390838181,31
1157,2008,95,107,130,112.9628451956,35
1157,2009,88,107,124,108.725031052408,36
1157,2011,89,103,130,107.470934395376,41
1157,2013,98,109,132,115.357366103122,34
1157,2014,82,102,122,104.414247445787,40
1157,2015,94,108,123,113.047951508737,29
1159,2008,95,104,130,110.949858317785,35
1159,2009,66,101,139,103.04854814039,73
1159,2011,89,118,131,114.927744414606,42
1159,2013,94,108,129,116.01977448428,35
1159,2014,88,99,114,103.296897075046,26
1159,2015,90,116,144,119.287366859563,54
1161,2009,86,101,123,108.102718583072,37
1161,2013,103,108,130,115.349804436642,27
1161,2014,86,100,126,104.582987435904,40
1161,2015,100,114,134,118.998938126849,34
1162,2009,90,105,123,108.373596754345,33
1162,2011,116,123,130,126.345690819995,14
1163,2011,89,101,125,108.191885220818,36
1163,2013,94,106,125,111.050549450391,31
1163,2014,88,108,130,111.480894446842,42
1163,2015,92,106,121,111.694306074544,29
1164,2011,88,102,130,109.376409948019,42
1164,2013,97,110,126,113.880999169889,29
1164,2014,79,99,108,100.023085804305,29
1164,2015,101,113,130,115.07872494576,29
1165,2011,89,103,125,107.730158494885,36
1166,2011,81,110,131,109.498820857567,50
1166,2014,88,102,116,104.566669131702,28
1166,2015,91,106,128,110.732002406507,37
1168,2013,103,115,129,117.923704468728,26
1168,2014,88,111,130,111.788994629158,42
1168,2015,94,107,133,116.213450591704,39
1169,2013,97,113,130,116.119501479623,33
1169,2014,79,92,108,98.369360656487,29
1169,2015,101,115,137,117.999870126618,36
1170,2013,97,116,128,114.770863533314,31
1172,2014,80,97,121,103.684714238214,41
1172,2015,102,123,144,127.552652933399,42
1173,2014,83,98,113,102.915981959889,30
1173,2015,92,106,135,115.278000589245,43
1175,2014,79,96,113,100.236561563533,34
1175,2015,94,106,130,114.766871690249,36
1176,2014,85,100,113,101.920593211633,28
1176,2015,91,106,129,112.956290723753,38
1177,2014,90,100,122,104.034751521473,32
1178,2014,90,99,113,102.828124945889,23
1178,2015,95,106,123,111.845034005266,28
1179,2015,94,106,128,112.594059088812,34
1180,2015,92,106,134,113.754478544557,42
1181,2015,96,107,130,114.947990578251,34
1208,2009,83,93,137,105.785069748168,54
1208,2011,88,132,154,124.877403849815,66
1208,2013,100,113,141,123.076082946007,41
1208,2014,81,112,129,109.732232428134,48
1208,2015,85,112,143,119.097618825472,58
1209,2006,85,100,107,102.777473813383,22
1209,2007,78,88,119,96.1993622329494,41
1209,2008,82,103,138,111.341064326291,56
1209,2009,74,103,116,101.458019493065,42
1209,2011,53,101,141,101.895195502965,88
1210,2006,84,95,102,98.2531953138197,18
1210,2007,77,98,126,101.517994369517,49
1210,2008,85,101,114,104.004687573387,29
1210,2009,74,90,109,95.2129120749657,35
1210,2011,67,81,113,90.3981829794454,46
1210,2013,95,100,123,108.293454788763,28
1210,2014,81,105,114,103.369785999034,33
1210,2015,85,102,116,103.67128411869,31
1213,1995,96,110,128,115.58832605349,32
1213,1996,101,116,134,121.983421564196,33
1213,1997,101,121,143,125.829342263971,42
1213,1998,109,123,144,129.159082273949,35
1213,2000,88,120,134,118.279801758433,46
1213,2001,88,116,137,115.971116275773,49
1213,2006,93,116,137,118.658728542976,44
1213,2007,95,125,152,126.125060375806,57
1213,2008,110,129,143,130.494080152389,33
1213,2009,86,125,145,122.592257870024,59
1213,2011,92,121,141,121.158014732941,49
1213,2013,100,117,144,123.876558600813,44
1213,2014,86,115,134,116.034898834462,48
1213,2015,79,121,163,122.245644020363,84
1214,1995,95,107,123,109.436859840008,28
1214,1996,91,108,123,112.702978380211,32
1214,1997,96,110,137,115.333292686594,41
1214,1998,88,118,141,118.220003475535,53
1214,2000,88,108,134,115.437559430595,46
1220,1995,95,109,130,112.919330255212,35
1220,1996,91,118,139,118.211917475739,48
1220,1997,97,111,129,117.562414072948,32
1220,1999,87,109,137,114.051249896949,50
1220,2000,88,109,134,114.984291540364,46
1220,2001,92,113,136,115.8040409515,44
1220,2002,95,113,134,119.574874354456,39
1220,2003,78,106,127,108.124833890002,49
1220,2004,95,113,134,117.193830302008,39
1220,2005,85,106,137,113.686490527374,52
1220,2009,85,102,127,105.489042033389,42
1220,2011,90,116,145,118.439896856015,55
1220,2013,100,123,148,124.880033298554,48
1220,2014,78,107,142,112.23773840047,64
1220,2015,85,100,134,110.972593114573,49
1221,1995,97,99,124,109.527966712649,27
1221,1996,97,116,135,117.313961495773,38
1221,2000,93,117,134,117.357593103599,41
1221,2006,89,102,127,110.219996074676,38
1221,2007,88,125,153,124.242147177066,65
1221,2008,90,114,143,121.465384614152,53
1221,2009,83,103,135,110.411550783024,52
1221,2011,81,102,136,107.53714286542,55
1221,2013,99,116,135,124.356351171636,36
1221,2014,79,109,129,112.27637228866,50
1221,2015,95,116,143,120.83077864478,48
1224,2006,92,114,137,114.861587057116,45
1224,2007,81,107,128,110.6333900358,47
1224,2008,102,123,144,126.363167522594,42
1224,2009,91,116,138,117.946838201451,47
1224,2011,72,117,165,120.399052957286,93
1224,2013,109,125,140,126.767511429166,31
1224,2014,92,113,131,115.754177410659,39
1224,2015,73,116,159,118.88647376765,86
1226,2006,78,100,120,103.274591878191,42
1226,2007,84,105,119,103.562102435448,35
1226,2008,83,104,124,107.588082154732,41
1226,2009,74,96,116,98.0822529408127,42
1226,2011,70,101,136,101.588527288387,66
1227,2006,91,116,121,112.333533363836,30
1227,2007,88,131,172,132.167066393923,84
1227,2014,81,108,131,111.292112439238,50
1227,2015,79,108,144,113.496204150416,65
1229,2013,103,135,155,136.547450787189,52
1229,2014,92,121,149,125.948717947786,57
1230,2013,95,116,144,120.301866943816,49
1230,2014,73,101,122,103.17535272147,49
1230,2015,79,100,128,105.126536354932,49
1231,2014,74,93,113,96.2533252711314,39
1231,2015,85,100,122,104.497956530981,37
1232,2014,79,100,130,105.18435181523,51
1232,2015,67,106,151,111.313344875904,84
1233,2015,88,106,123,108.499357505889,35
1301,1995,90,99,113,104.408663617315,23
1301,2001,85,104,120,106.035313190769,35
1301,2002,84,102,119,104.199038660704,35
1301,2003,74,90,106,94.5103140291195,32
1301,2004,81,104,118,103.627083849475,37
1301,2005,81,94,116,101.355106579729,35
1301,2006,81,97,115,100.348029805547,34
1301,2007,81,102,115,104.132611758077,34
1301,2008,81,99,123,106.539897149132,42
1301,2009,79,104,121,105.593321494377,42
1301,2011,81,102,131,107.256332213398,50
1301,2013,101,112,128,115.485801195949,27
1301,2014,83,101,117,105.036377077505,34
1301,2015,90,109,122,109.275896707675,32
1304,2011,75,100,123,101.333183303835,48
1304,2014,90,102,123,109.07907014047,33
1305,2002,88,116,143,119.226285588471,55
1305,2003,83,101,128,106.975131708958,45
1305,2004,96,119,136,120.352168060992,40
1305,2005,87,107,129,110.284866433689,42
1305,2006,84,102,127,106.273451060497,43
1305,2007,89,115,160,123.572233668804,71
1305,2008,105,116,137,124.36264935601,32
1305,2009,84,89,130,99.3780957727123,46
1305,2013,87,118,134,117.031969206624,47
1305,2014,86,109,128,109.568534016632,42
1305,2015,79,95,109,100.740935950218,30
1306,2000,89,110,130,113.082564573609,41
1306,2001,90,106,132,111.071085579223,42
1306,2002,85,111,129,112.567815820012,44
1306,2003,78,97,113,101.640746135582,35
1306,2004,74,116,143,115.726591494667,69
1306,2005,88,119,135,120.338692631099,47
1306,2006,92,106,115,109.65221772913,23
1306,2007,89,106,130,113.749059201476,41
1306,2008,95,115,136,121.119822901611,41
1306,2009,78,103,122,106.494036234964,44
1306,2011,78,100,127,105.773690172145,49
1306,2013,95,111,123,111.10696805626,28
1306,2014,88,109,120,108.677549832219,32
1306,2015,90,107,128,111.633273894206,38
1307,1994,60,102,144,105.36645303318,84
1307,1995,87,102,113,105.013379782587,26
1307,2001,74,105,113,102.391618615252,39
1307,2002,87,95,115,102.606612280625,28
1307,2003,81,95,116,98.7292598419151,35
1307,2004,73,100,116,103.030255880472,43
1307,2005,84,99,113,102.693332675873,29
1307,2006,81,95,115,97.6295699232957,34
1307,2007,72,90,109,96.3773903157889,37
1307,2008,80,105,126,106.870292410054,46
1307,2009,75,92,116,98.3866139142645,41
1307,2011,82,103,124,105.739309172421,42
1307,2013,98,110,128,114.704439540994,30
1307,2014,78,100,121,104.104802243231,43
1307,2015,90,108,128,109.991897084407,38
1309,2001,94,122,143,124.800213595867,49
1309,2002,88,124,154,122.353795103212,66
1309,2003,86,123,142,120.837440789914,56
1309,2004,102,127,153,130.305972176879,51
1309,2005,102,133,150,130.212822290171,48
1309,2006,88,115,149,124.029247900338,61
1309,2007,78,115,155,122.675269930608,77
1309,2008,96,132,158,132.152014476602,62
1309,2009,88,114,149,119.298926368137,61
1309,2011,79,118,154,121.44087932129,75
1309,2013,97,111,148,122.360868526181,51
1309,2014,78,103,127,106.78527519927,49
1309,2015,81,107,138,111.347716252489,57
1310,1996,92,106,127,110.666666870093,35
1310,1997,71,92,113,95.5189428809295,42
1310,1998,85,106,127,110.032421708522,42
1310,1999,78,99,120,101.314041259842,42
1310,2000,85,99,120,103.597236520521,35
1310,2001,85,99,113,102.216342819748,28
1310,2002,78,99,127,105.842311563306,49
1310,2003,86,106,128,109.313868631086,42
1310,2004,92,120,134,118.586325387681,42
1310,2005,88,106,120,107.935577324164,32
1310,2009,74,105,137,107.689614637679,63
1310,2011,75,105,130,108.884718899728,55
1310,2013,95,110,130,117.226700237869,35
1310,2014,82,102,119,103.130722316796,37
1310,2015,79,94,126,103.971746944542,47
1311,1986,97,107,131,114.036356005125,34
1311,1987,93,116,136,117.57361414791,43
1311,1988,88,102,125,107.40527963028,37
1311,1989,90,102,116,104.036663659832,26
1311,1990,80,102,123,104.355133070444,43
1311,1991,100,113,130,116.959319427203,30
1311,1992,82,98,114,101.778200080938,32
1311,1993,88,105,122,106.384502206483,34
1311,1994,91,100,122,108.475034367666,31
1311,1996,98,111,130,115.857546358487,32
1311,1997,81,102,118,105.896741468897,37
1311,1998,95,118,135,117.685085348586,40
1311,1999,91,108,123,110.291617208551,32
1311,2000,95,107,127,113.02709926262,32
1311,2001,94,106,127,111.08906166679,33
1311,2002,87,107,137,115.25191882793,50
1311,2003,81,95,124,101.329683921373,43
1311,2004,89,102,129,110.484836890592,40
1311,2005,88,99,124,104.58960383193,36
1311,2006,83,93,121,103.345687619933,38
1311,2007,88,102,113,107.591790581313,25
1311,2008,91,116,139,117.943690583924,48
1311,2009,75,92,117,99.1057796160844,42
1311,2011,81,102,131,107.03101212953,50
1311,2013,88,109,123,109.662629343679,35
1311,2014,79,86,107,96.1025215121836,28
1311,2015,78,92,107,96.2894735976926,29
1312,1993,88,114,164,122.72068248557,76
1312,1994,90,113,144,116.58908061836,54
1312,1995,86,107,128,109.585765951391,42
1312,1996,98,108,132,116.625757709193,34
1312,1997,91,111,134,114.701798805108,43
1312,1998,88,113,138,117.641220768414,50
1312,1999,96,106,128,112.661113949739,32
1312,2000,89,109,137,115.602593499136,48
1312,2001,86,107,121,110.794647525882,35
1312,2002,86,107,139,115.626766762437,53
1312,2003,82,100,127,106.253227430064,45
1312,2004,86,118,136,118.160304671078,50
1312,2005,88,110,134,116.292559197764,46
1312,2006,85,107,138,112.696623337295,53
1312,2007,98,122,153,124.912594043833,55
1312,2008,96,132,158,131.415277444161,62
1312,2009,85,107,141,117.726433228858,56
1312,2011,87,123,149,121.703714258929,62
1312,2013,101,125,149,128.43946221008,48
1312,2014,90,113,152,120.250481020679,62
1312,2015,85,109,144,115.320019770644,59
1313,1996,97,104,123,109.550627030093,26
1313,1997,92,116,137,116.285780874192,45
1313,1998,98,118,140,121.099968392069,42
1313,1999,87,104,126,109.33891120451,39
1313,2000,81,108,138,111.353254227467,57
1314,1995,87,103,119,105.148555345107,32
1314,1996,95,108,135,115.840012616137,40
1314,1997,74,88,109,94.8900218448972,35
1314,1998,81,102,127,108.061012712077,46
1314,1999,77,103,130,108.478534441275,53
1314,2000,81,102,126,106.429669631472,45
1314,2001,83,100,125,105.65257679069,42
1314,2002,87,102,118,104.352400753298,31
1314,2003,81,95,109,99.5170101362948,28
1314,2004,76,102,130,107.746025235702,54
1314,2005,81,95,119,101.687087100054,38
1314,2006,84,95,108,98.4005512440108,24
1314,2007,80,96,115,101.181187924861,35
1314,2008,86,112,123,111.003860826462,37
1314,2009,82,93,121,102.242424218227,39
1314,2011,70,95,125,99.7726951185893,55
1314,2013,88,106,120,109.310991019781,32
1314,2014,78,106,137,110.788161670958,59
1314,2015,82,95,122,103.647374444534,40
1315,1991,101,118,134,121.276365101217,33
1315,1992,75,97,114,98.0035882010001,39
1315,1993,81,93,113,96.8419412971632,32
1315,1994,81,96,109,99.719976771024,28
1315,1995,84,95,115,99.5456558645445,31
1315,1996,86,102,113,105.58936011812,27
1315,1997,81,93,115,98.1367352477775,34
1315,1998,82,99,140,109.778663407234,58
1315,1999,59,102,152,107.335630872187,93
1315,2000,80,97,116,99.3527364990284,36
1315,2001,83,93,115,99.9970758733978,32
1315,2002,74,95,116,99.3779706261792,42
1315,2003,81,96,115,101.872708866835,34
1315,2004,67,95,122,99.6539208386343,55
1315,2005,84,94,117,100.731650009618,33
1315,2006,81,95,109,99.782128655753,28
1315,2007,81,97,123,101.544043644067,42
1315,2008,84,95,125,102.877245627511,41
1315,2009,75,94,122,100.998955332158,47
1315,2011,72,95,122,99.0001734221216,50
1315,2013,95,102,113,106.324808528569,18
1315,2014,79,94,115,99.1987639808002,36
1315,2015,85,100,126,108.993195239016,41
1316,1989,60,89,115,90.3741916637053,55
1316,1990,70,93,116,95.9196841687135,46
1316,1991,82,116,158,120.324779299826,76
1317,1992,71,97,112,96.6213213231722,41
1317,1993,83,99,132,107.743125187167,49
1317,1994,92,102,116,105.67567435163,24
1317,1995,88,95,112,100.732776739789,24
1317,1996,86,113,141,118.638172366317,55
1317,1997,85,98,113,104.678873102045,28
1317,1998,104,107,114,109.245740531681,10
1317,1999,88,103,153,113.271888055443,65
1317,2000,81,98,122,102.087656889477,41
1317,2001,86,121,161,124.286591857182,75
1317,2002,86,117,130,114.326329863518,44
1317,2003,87,112,127,113.520136569294,40
1317,2004,81,97,114,101.403897170518,33
1317,2005,83,105,131,106.921377215114,48
1317,2006,81,95,108,99.7402971922579,27
1317,2007,81,101,121,102.422519722293,40
1317,2008,85,112,136,111.736898702454,51
1317,2009,76,93,114,98.2837751317107,38
1317,2011,82,102,113,102.43384875546,31
1317,2013,95,109,114,109.243864396911,19
1317,2014,85,99,120,104.204969671306,35
1317,2015,91,95,112,103.368008779198,21
1318,2001,94,115,137,118.768848936028,43
1318,2002,95,123,137,122.462920491958,42
1318,2003,81,106,128,107.602545301102,47
1318,2004,96,118,130,118.708874360223,34
1318,2005,95,106,129,113.744976451475,34
1318,2006,90,109,123,110.362062418112,33
1318,2007,81,116,151,117.973486345995,70
1318,2008,92,113,136,117.66643195133,44
1318,2009,83,107,128,110.25941676327,45
1318,2011,74,102,137,108.357072347984,63
1318,2013,95,116,130,116.829760558401,35
1318,2014,82,98,118,101.939399970643,36
1318,2015,88,112,137,113.055576868625,49
1319,2001,85,100,123,108.058252426667,38
1319,2002,80,104,120,105.713503774973,40
1319,2003,81,100,125,104.561538461275,44
1319,2004,82,104,128,107.866197155467,46
1319,2005,82,102,124,106.294354807686,42
1319,2006,82,99,123,103.454826683982,41
1319,2007,73,98,122,102.021624880885,49
1319,2008,78,101,129,107.747142647151,51
1319,2009,84,102,121,104.919910172722,37
1319,2011,72,101,127,104.649078527468,55
1319,2013,97,106,136,116.582939033339,39
1319,2014,78,102,120,103.294317402176,42
1319,2015,80,94,122,98.8312452299801,42
1320,1995,88,102,116,104.602366474462,28
1320,1996,86,110,127,113.510567935362,41
1320,1997,85,112,128,110.543681601703,43
1320,1998,80,98,131,104.730615085653,51
1320,1999,83,103,118,102.85767845976,35
1320,2000,84,103,121,106.318162616696,37
1320,2001,88,103,121,107.666844779152,33
1320,2002,85,104,120,106.898280056915,35
1320,2003,81,97,119,103.305474465011,38
1320,2004,89,107,130,112.304388404843,41
1320,2005,81,101,124,105.53209593599,43
1320,2006,81,105,125,106.013540935226,44
1320,2007,81,101,115,101.48884328383,34
1320,2008,89,111,132,111.645247162061,43
1320,2009,77,94,116,97.5675426924779,39
1320,2011,76,100,130,106.96079186766,54
1320,2013,74,102,137,106.918320897841,63
1321,1997,96,123,141,124.025345729795,45
1321,1998,96,127,151,130.657127585588,55
1321,1999,88,102,144,111.63719569351,56
1321,2000,88,117,141,119.201352270065,53
1321,2001,85,120,150,124.806558255947,65
1321,2002,87,132,167,131.56208901228,80
1321,2003,86,118,145,121.169230769876,59
1321,2004,101,124,148,127.942356836073,47
1321,2005,94,129,155,130.401534710171,61
1321,2006,90,126,157,123.833063349728,67
1321,2007,98,135,157,133.305970955064,59
1321,2008,78,120,152,121.667370902279,74
1321,2009,76,116,159,119.078666951062,83
1321,2011,82,115,153,120.381339565412,71
1321,2013,91,106,151,120.196888602747,60
1321,2014,82,113,144,116.892712325509,62
1321,2015,85,125,160,125.70724935539,75
1322,2002,85,121,155,126.109492229698,70
1322,2003,95,124,142,123.734133723576,47
1322,2004,100,123,143,127.26620473891,43
1322,2005,105,117,150,124.577653688037,45
1322,2006,98,109,144,118.454525986355,46
1322,2007,89,123,153,125.472176913437,64
1322,2008,101,121,152,127.771502967444,51
1322,2009,87,118,149,120.596214762736,62
1322,2011,88,122,155,122.68319748749,67
1322,2013,95,113,142,118.956220661331,47
1322,2014,80,107,129,109.899338481605,49
1322,2015,84,100,140,110.548991938308,56
1323,2001,88,99,125,107.535800523321,37
1323,2002,90,111,130,115.429919467611,40
1323,2003,86,103,126,107.996968542467,40
1323,2004,89,109,128,111.757534001039,39
1323,2005,92,106,131,111.183127560356,39
1323,2006,85,99,120,106.330292810782,35
1323,2007,88,109,130,110.105459897317,42
1323,2008,86,107,128,109.587537079731,42
1323,2009,85,100,127,105.553559695352,42
1323,2011,79,100,132,105.244511173331,53
1323,2013,101,113,128,115.431880746718,27
1323,2014,81,93,113,98.6666666547269,32
1323,2015,85,101,123,107.506203058408,38
1324,2003,78,95,113,98.9151783600364,35
1324,2004,71,86,114,95.4482621669923,43
1324,2005,81,95,106,99.3526585940806,25
1324,2006,77,90,109,96.1247067680847,32
1325,2003,82,101,124,104.892307698278,42
1325,2004,83,101,129,107.594055635738,46
1325,2005,88,101,121,103.607326375541,33
1325,2006,85,99,113,104.153306135211,28
1325,2007,81,98,113,101.466983989247,32
1325,2008,85,110,123,112.367530707701,38
1325,2009,75,96,125,100.326353347801,50
1325,2011,72,93,136,103.920641094985,64
1325,2013,96,109,125,114.063903631394,29
1325,2014,82,100,121,102.922084350288,39
1325,2015,81,102,123,105.245491938039,42
1326,2003,87,113,134,116.505816309807,47
1327,2003,84,98,116,105.188239008111,32
1328,2004,95,123,153,126.786701029583,58
1328,2005,88,109,145,116.772233611946,57
1328,2006,81,112,137,113.356017371747,56
1328,2007,74,100,146,109.92134524585,72
1328,2008,89,115,136,116.40224642589,47
1328,2009,77,111,141,115.434430263322,64
1328,2011,82,116,154,119.93042790943,72
1328,2013,96,115,135,117.055835387956,39
1328,2014,78,105,120,107.296719176654,42
1328,2015,84,112,138,114.293979927334,54
1329,2004,95,119,139,118.528477175659,44
1329,2005,82,102,124,107.871280843241,42
1329,2006,85,94,115,103.05139481379,30
1329,2007,89,115,154,122.109102197727,65
1329,2008,105,116,131,118.758076555112,26
1329,2009,84,89,130,100.508753590761,46
1329,2013,76,118,151,116.458227481958,75
1329,2014,78,99,128,105.116414166024,50
1329,2015,79,95,102,96.794234199892,23
1331,2002,89,104,125,107.116534860646,36
1332,2002,90,104,124,106.538972595409,34
1333,2002,102,117,123,118.152511237272,21
1334,2002,90,105,124,111.017065009084,34
1335,2005,87,100,124,106.845660375305,37
1335,2006,78,92,116,98.5845617147089,38
1335,2007,70,98,123,101.92814810298,53
1335,2008,81,103,129,107.192375841331,48
1335,2009,79,95,124,103.761646637666,45
1335,2011,81,109,137,112.370879571455,56
1335,2014,78,95,123,102.852560163851,45
1335,2015,83,95,137,106.278737558219,54
1336,2003,87,109,130,110.72144047822,43
1336,2004,88,119,130,117.573297891394,42
1336,2005,82,106,140,112.325218473395,58
1336,2006,89,102,125,108.56154321332,36
1336,2007,78,109,134,112.69356784061,56
1336,2008,92,116,134,118.109426519962,42
1336,2009,80,92,129,105.137251311323,49
1336,2011,81,111,137,112.086682403385,56
1336,2013,98,114,128,118.373553657699,30
1336,2014,64,101,128,105.100776038984,64
1336,2015,86,100,131,107.454051598976,45
1337,2003,67,112,151,113.427592812465,84
1337,2004,96,118,144,120.677265816983,48
1337,2005,95,116,145,120.267553438712,50
1337,2006,90,108,143,116.970254145859,53
1337,2007,74,123,168,125.525770995776,94
1337,2008,92,119,152,124.966368296704,60
1337,2009,87,105,136,113.787892630502,49
1339,2003,95,123,150,127.056455684372,55
1339,2004,96,130,151,128.574189630959,55
1339,2005,94,139,165,135.364430101533,71
1339,2006,92,128,156,127.453218173897,64
1339,2007,88,128,162,131.460531336861,74
1339,2008,99,137,166,136.800626945345,67
1339,2009,87,128,158,127.688556546005,71
1339,2011,72,123,155,120.791436226988,83
1339,2013,92,130,149,129.113189727062,57
1339,2014,85,120,150,123.223557692389,65
1339,2015,85,124,150,124.494827348251,65
1340,2003,83,104,128,105.643474777697,45
1340,2004,93,114,135,118.638531236869,42
1340,2005,88,109,130,112.997527414447,42
1340,2006,81,103,124,106.263094825281,43
1340,2007,80,99,130,108.606143725357,50
1340,2008,89,109,130,113.001040111959,41
1340,2009,86,102,125,106.957585093865,39
1340,2011,81,102,130,106.848101076483,49
1340,2013,99,117,129,119.515279713025,30
1340,2014,86,108,130,111.655211119585,44
1340,2015,94,100,130,110.851110267028,36
1341,2002,78,105,124,105.084586828516,46
1342,2002,78,104,135,110.018419658934,57
1343,2002,67,107,151,111.46389930476,84
1343,2003,86,113,141,116.980495498787,55
1343,2004,69,106,158,114.502459298655,89
1343,2005,68,117,158,119.443196470742,90
1343,2006,86,102,128,113.408018842906,42
1343,2007,89,109,144,117.470290398151,55
1343,2008,95,121,152,124.940968524464,57
1343,2009,81,111,136,110.291135585036,55
1343,2011,75,95,137,105.56655257372,62
1343,2013,91,112,134,116.234310068724,43
1343,2014,73,93,116,99.3333045963257,43
1343,2015,71,100,129,102.997982112338,58
1344,2002,85,106,130,109.556433837135,45
1344,2003,71,112,140,111.666375386521,69
1344,2004,81,102,119,104.062695130908,38
1344,2005,82,102,123,106.95017951761,41
1344,2006,53,102,151,107.085304011959,98
1344,2007,102,116,123,116.680778371475,21
1344,2008,85,107,137,113.954197158296,52
1344,2009,74,94,130,103.227715607833,56
1344,2011,65,95,130,98.7831362347566,65
1344,2013,98,113,134,118.660575835624,36
1344,2014,78,106,127,107.980212724413,49
1344,2015,76,102,137,109.88694004552,61
1345,2002,95,102,116,108.177848410605,21
1345,2003,78,115,149,119.874520430254,71
1345,2004,63,112,158,113.502350487419,95
1345,2005,74,89,123,98.8581147483809,49
1345,2006,95,95,102,101.654349801705,7
1345,2008,43,69,88,70.7182563707985,45
1345,2011,49,75,109,81.5595509634167,60
1345,2015,86,107,130,108.93914851379,44
1346,1998,74,124,165,123.26660777073,91
1346,1999,53,88,122,90.6480662119238,69
1346,2001,95,114,146,122.018587840373,51
1346,2002,95,123,144,123.983745664354,49
1346,2003,87,109,129,111.265286879612,42
1346,2004,106,137,165,138.099408350622,59
1346,2005,74,102,131,107.576296709482,57
1346,2006,84,102,130,108.185010222251,46
1346,2007,74,102,137,108.51947803054,63
1346,2008,92,136,172,136.103731398369,80
1346,2009,110,127,161,134.147130186454,51
1346,2011,94,116,143,120.466633593686,49
1346,2013,74,119,151,118.768830378781,77
1346,2014,88,103,107,104.842850587083,19
1346,2015,65,102,144,107.590656635463,79
1347,2005,67,87,107,93.862470320962,40
1347,2006,81,123,158,124.0437837374,77
1347,2007,64,109,144,109.805427318756,80
1347,2008,61,95,130,99.1902030595231,69
1348,2005,89,109,138,114.951613559771,49
1348,2006,88,99,137,110.586677121998,49
1348,2007,71,105,115,101.386412448524,44
1348,2008,92,115,142,119.434257597414,50
1348,2009,89,95,116,103.908087829897,27
1349,2003,81,95,116,99.1490713872347,35
1349,2004,81,96,123,104.121963666837,42
1349,2005,88,101,117,106.10979788787,29
1349,2006,71,97,126,100.862635435989,55
1349,2007,81,105,113,103.732648904755,32
1349,2008,92,113,136,115.235462045782,44
1349,2009,79,100,122,103.568190850639,43
1349,2014,81,100,115,100.784074320975,34
1349,2015,85,100,130,107.837782489331,45
1351,2006,78,109,120,107.451319938854,42
1351,2007,89,118,137,116.337137882327,48
1351,2008,95,117,145,123.254497596488,50
1351,2009,88,95,133,106.126759496832,45
1351,2011,75,108,146,111.318369087697,71
1351,2013,99,117,128,118.167517518404,29
1351,2014,81,99,128,105.034739417796,47
1351,2015,74,96,124,100.018768537328,50
1352,2007,88,116,150,121.537611805923,62
1353,2007,85,107,130,109.244601409139,45
1353,2008,95,106,130,112.75191037353,35
1353,2009,80,93,129,105.469136870319,49
1353,2011,67,102,132,103.207210456853,65
1354,2007,84,100,147,112.810007038792,63
1354,2008,85,116,145,118.92043601035,60
1354,2009,80,101,145,108.948737309406,65
1354,2011,72,102,141,106.744910876501,69
1354,2013,96,117,153,122.192188026441,57
1354,2014,74,100,135,105.696975680869,61
1354,2015,81,102,144,111.051090784373,63
1355,2007,78,101,130,106.80471963625,52
1355,2008,89,107,131,111.259845891357,42
1355,2009,84,94,123,100.549953909139,39
1355,2011,86,93,129,105.139929980247,43
1355,2013,87,99,125,110.550979424265,38
1355,2014,75,92,118,99.1987921440456,43
1355,2015,78,92,125,103.08162960259,47
1356,2005,90,104,133,111.120444168776,43
1356,2006,91,105,137,109.588836833877,46
1356,2007,84,106,147,114.842165932375,63
1356,2008,91,112,137,117.24454982607,46
1356,2009,83,104,130,109.041672078563,47
1356,2011,81,102,130,107.15994440235,49
1356,2013,97,107,130,113.024381208817,33
1356,2014,74,100,129,105.373671168675,55
1356,2015,88,101,122,106.246053496532,34
1357,2007,74,110,130,108.059611711105,56
1357,2008,78,115,137,114.662812513171,59
1357,2009,82,105,130,107.769322913746,48
1357,2011,64,102,136,104.318583988495,72
1357,2013,96,106,134,115.98477219436,38
1357,2014,82,119,150,119.596663498692,68
1357,2015,85,116,150,118.695333593304,65
1358,2005,90,104,132,110.399040551919,42
1358,2006,91,106,121,110.067256306032,30
1358,2007,89,123,151,124.661913951925,62
1358,2008,96,116,137,118.552753879239,41
1358,2009,84,98,131,106.264464361012,47
1358,2011,91,106,144,113.773373779389,53
1358,2013,92,108,142,115.729079845815,50
1358,2014,86,107,137,114.108305122988,51
1358,2015,88,106,139,112.722102602489,51
1359,2007,76,95,123,100.544408871291,47
1360,2006,84,97,117,103.478298459486,33
1360,2007,80,102,122,103.679563825374,42
1360,2008,84,112,128,109.802877309819,44
1361,1999,109,116,123,121.149017460367,14
1361,2000,95,116,137,117.414067736507,42
1361,2001,88,102,116,105.532017673815,28
1361,2002,103,120,144,125.469871889775,41
1361,2003,85,115,134,114.678334564819,49
1361,2004,90,116,144,121.542686057773,54
1361,2005,89,112,137,118.599456160222,48
1361,2006,85,103,131,111.288333760003,46
1361,2007,94,118,137,118.617925923116,43
1361,2008,84,116,152,119.118541824794,68
1361,2009,90,109,140,114.781417699583,50
1361,2011,88,117,146,119.579042967394,58
1361,2013,98,107,135,115.849043822096,37
1361,2014,78,99,130,107.46059878112,52
1361,2015,90,100,120,108.718808263131,30
1362,2006,91,110,130,109.996214062201,39
1362,2007,84,109,145,114.060738663338,61
1362,2008,98,123,144,124.770174852096,46
1362,2009,81,118,141,116.25107423198,60
1362,2011,87,116,144,117.681004179847,57
1362,2013,104,125,144,125.464343864294,40
1362,2014,85,106,130,111.525385095428,45
1362,2015,95,114,139,118.426668090138,44
1363,2007,81,103,124,107.856293675349,43
1363,2008,74,109,144,110.328984286968,70
1363,2009,83,95,113,99.9209799214459,30
1367,2008,85,111,134,112.392670157725,49
1367,2009,90,101,122,107.591821734131,32
1368,2008,99,137,169,140.133258412442,70
1368,2009,83,139,180,134.952382333772,97
1368,2011,81,127,155,127.963474975827,74
1368,2013,92,130,156,129.786619865537,64
1368,2014,103,131,162,134.561027826362,59
1368,2015,100,139,155,133.904638926458,55
1369,2008,81,101,123,106.868670170193,42
1369,2009,84,96,121,102.068621979799,37
1369,2011,72,101,136,107.613457505124,64
1369,2013,96,106,136,115.172288547149,40
1369,2014,78,102,120,106.631892460268,42
1369,2015,80,94,122,103.095313935707,42
1370,2007,80,100,121,105.458478711579,41
1370,2008,78,102,121,104.725883788991,43
1370,2009,82,92,122,100.702506063612,40
1370,2011,75,101,127,103.354351678582,52
1370,2013,96,106,129,111.557622735248,33
1370,2014,83,100,114,101.489539748388,31
1370,2015,86,107,123,109.075993090958,37
1371,2008,85,107,130,109.385957837897,45
1371,2009,75,102,130,104.505926078651,55
1371,2011,74,101,130,105.053870347045,56
1371,2013,91,109,130,112.310720350882,39
1371,2014,82,94,123,102.426409073838,41
1371,2015,60,92,134,99.0835836300035,74
1372,2008,85,113,144,119.577064445329,59
1372,2009,84,92,135,105.382945498282,51
1372,2011,89,125,154,126.91606801738,65
1372,2013,88,103,137,112.320523351918,49
1372,2014,80,95,108,99.6609824173522,28
1372,2015,39,74,107,78.3539656121128,68
1373,2006,79,109,127,109.957519176235,48
1373,2007,78,106,137,109.260290820743,59
1373,2008,85,113,144,119.018618711277,59
1373,2009,81,109,135,110.576887375085,54
1373,2011,90,125,144,123.890267965496,54
1373,2013,96,114,136,117.801236530684,40
1374,2009,84,102,121,103.237195279344,37
1374,2011,81,95,124,102.344201178173,43
1374,2013,92,107,130,113.01921860762,38
1374,2014,74,95,115,98.0605106329233,41
1374,2015,91,129,144,123.706566167291,53
1375,2009,77,90,109,94.4207043647225,32
1375,2011,75,96,117,96.8385415236174,42
1375,2013,96,106,123,109.24297979582,27
1375,2014,75,90,114,96.7137537235395,39
1375,2015,80,92,108,97.8643275291566,28
1376,2009,72,109,145,111.097435866489,73
1376,2011,73,87,137,100.295416202744,64
1376,2013,80,106,135,112.296319887472,55
1376,2014,81,92,107,97.5712123391129,26
1376,2015,88,101,116,103.763788194202,28
1377,2004,81,109,151,116.588264976261,70
1377,2005,92,106,131,110.179687495849,39
1377,2006,78,99,120,102.931273638876,42
1377,2007,78,109,130,109.105569449292,52
1377,2008,86,104,121,108.731903221025,35
1377,2009,82,93,116,98.1411737084001,34
1377,2011,67,109,151,112.857793717347,84
1377,2013,96,106,129,112.65591928746,33
1377,2014,81,95,114,100.977326483115,33
1377,2015,80,99,128,106.936722888115,48
1378,2009,81,101,124,106.366315195769,43
1378,2011,84,101,131,108.875246472078,47
1378,2013,97,116,134,119.014412428702,37
1378,2014,81,109,130,109.152049056498,49
1378,2015,90,106,128,111.298561135391,38
1379,2009,85,113,141,118.379593292902,56
1379,2011,81,116,141,114.965517209199,60
1379,2013,99,123,145,122.563836383374,46
1379,2014,82,108,128,109.749977377338,46
1379,2015,94,123,151,123.949993958031,57
1380,2009,85,101,131,109.547327151492,46
1380,2011,77,109,146,115.863986545916,69
1380,2013,98,116,137,120.430049399071,39
1380,2014,78,101,121,107.660485967383,43
1380,2015,90,105,137,111.134607008871,47
1381,2011,74,87,101,90.0756927630635,27
1382,2011,84,118,143,117.025740841873,59
1382,2014,79,98,130,105.305598031363,51
1382,2015,81,95,130,103.686561244121,49
1383,2011,75,95,131,101.800011386232,56
1383,2013,90,116,142,118.238911229448,52
1383,2014,82,107,128,107.70625797511,46
1383,2015,84,100,129,106.800088975723,45
1384,2011,76,92,121,99.7976878645675,45
1384,2013,100,107,123,113.84660108752,23
1384,2014,79,101,115,100.704627865438,36
1385,2011,82,102,131,108.028673835596,49
1385,2013,100,107,128,116.750571663567,28
1385,2014,80,101,120,105.206659687814,40
1386,2013,91,110,136,115.47894832536,45
1387,2013,96,108,131,114.789268517977,35
1387,2014,63,102,144,104.487416448431,81
1388,2013,92,103,114,108.507141769877,22
1388,2014,81,107,128,109.686389151231,47
1388,2015,81,93,116,101.275553904014,35
1389,2013,99,114,134,120.261286445284,35
1389,2014,79,101,123,106.062131754945,44
1389,2015,83,102,133,109.232985244602,50
1390,2013,86,102,113,105.639831250957,27
1390,2014,79,88,109,95.3711019660512,30
1391,2013,92,108,116,108.711415481968,24
1391,2014,74,102,129,104.089465731289,55
1391,2015,85,92,107,98.8057495352835,22
1392,2013,97,102,118,111.711670755151,21
1392,2014,73,94,114,97.0258661916059,41
1393,2013,98,116,137,120.423289900873,39
1393,2014,78,94,116,100.794762613361,38
1393,2015,74,106,151,113.612536862651,77
1394,2013,95,108,123,111.98085723837,28
1394,2014,79,94,116,98.9002007688945,37
1394,2015,60,102,151,107.533685208297,91
1396,2014,86,93,120,102.269733825044,34
1396,2015,87,95,127,105.611195209286,40
1397,2014,78,105,128,107.085708996779,50
1397,2015,73,92,122,99.1792993998186,49
1398,2014,81,97,118,103.175097294364,37
1398,2015,77,116,151,117.684882126196,74
1399,2014,74,93,121,102.660532728257,47
1399,2015,60,109,164,113.808183082988,104
1401,1995,91,103,135,111.103879875758,44
1401,1996,99,121,151,126.856526256443,52
1401,1997,100,120,136,123.08866454669,36
1401,1998,111,132,151,134.376363654338,40
1401,1999,95,116,145,119.853560207342,50
1401,2000,95,117,137,119.735720280819,42
1401,2001,84,116,151,120.048748583039,67
1401,2002,95,116,144,121.744122115186,49
1401,2003,95,109,130,115.451850044374,35
1401,2004,116,135,155,136.743759543301,39
1401,2005,95,116,158,125.494038076735,63
1401,2006,97,115,158,124.844744280767,61
1401,2007,87,134,164,134.827239033507,77
1401,2008,101,128,161,133.413974946086,60
1401,2009,87,133,158,126.879371495408,71
1401,2011,88,124,155,126.477602788566,67
1401,2013,102,130,156,131.680379573784,54
1401,2014,85,114,135,114.93346808912,50
1401,2015,85,126,151,125.557836173229,66
1402,1998,126,136,167,144.105472635181,41
1402,1999,109,128,151,133.018759746438,42
1402,2000,118,139,157,143.062545895602,39
1402,2001,116,136,158,141.443036613219,42
1402,2002,118,143,157,143.019189941036,39
1402,2003,109,128,152,134.445186745787,43
1402,2004,115,133,161,138.586845544955,46
1402,2005,108,125,150,131.535746713018,42
1402,2006,99,133,162,133.305630781901,63
1402,2007,115,134,165,140.287324902768,50
1402,2008,111,132,160,135.236017690166,49
1402,2009,108,130,151,130.061057557616,43
1402,2011,116,142,158,143.7942404802,42
1402,2015,95,130,165,134.256256746758,70
1404,1990,102,125,144,126.209715066079,42
1404,1991,116,138,157,139.3264595898,41
1404,1992,95,121,144,123.248377862189,49
1404,1993,93,122,154,126.952180179329,61
1404,1994,105,120,141,126.629647851434,36
1404,1995,92,119,138,123.128569983563,46
1404,1996,109,130,149,132.62278769063,40
1404,1997,109,130,151,130.187695101843,42
1404,1998,109,132,158,138.01056570453,49
1404,1999,97,128,147,127.594876771624,50
1404,2000,108,128,149,131.656569741717,41
1404,2001,87,120,156,126.058392947813,69
1404,2002,96,126,147,128.109430604013,51
1404,2003,84,112,139,115.794584661665,55
1404,2004,96,123,147,124.2351576925,51
1404,2005,94,113,136,117.501296175962,42
1404,2006,86,107,128,112.422642647597,42
1404,2007,80,118,148,118.262323100251,68
1404,2008,83,113,139,116.597325024747,56
1404,2009,82,104,146,113.831049477194,64
1404,2011,88,133,151,124.577207961803,63
1404,2013,97,117,151,124.905718820611,54
1404,2014,67,105,137,106.983775748227,70
1404,2015,90,116,143,118.237811813652,53
1406,2001,99,120,141,125.014052996018,42
1407,2002,116,142,156,142.024607362206,40
1407,2003,110,129,146,131.287829711666,36
1407,2004,117,132,141,135.507893766464,24
1407,2005,110,134,162,139.018255267036,52
1407,2006,102,127,162,134.528788885367,60
1407,2007,100,134,155,134.721036382558,55
1407,2008,102,129,152,129.397622557195,50
1407,2009,92,127,149,126.097352672425,57
1407,2011,92,137,155,133.945832711401,63
1407,2013,106,128,155,133.194487385774,49
1407,2014,98,115,142,121.468632654545,44
1409,2001,95,116,137,119.102235874098,42
1409,2003,94,123,144,125.585155907371,50
1410,1989,53,102,151,104.824112553222,98
1410,1990,95,116,144,123.019395549544,49
1410,1991,109,130,150,134.625276345139,41
1410,1992,87,115,151,122.408974112253,64
1410,1993,90,111,144,118.371209367659,54
1410,1994,88,112,127,112.739655738685,39
1410,1995,91,116,144,118.801727876202,53
1410,1996,74,116,158,118.840415008921,84
1410,1997,68,109,151,112.389739475745,83
1410,1998,74,123,165,124.096496782835,91
1410,1999,85,109,137,113.53028450927,52
1410,2000,95,123,144,125.16492362635,49
1410,2001,94,116,136,120.125282569615,42
1410,2002,102,130,156,130.972417659918,54
1410,2003,101,120,135,123.72211990837,34
1410,2008,81,117,158,120.924169626148,77
1410,2009,80,130,151,127.273828169762,71
1410,2011,67,114,158,117.071951086046,91
1410,2013,101,115,137,122.085690327886,36
1410,2014,36,88,143,94.7915447531007,107
1410,2015,85,109,139,115.224976205547,54
1411,1997,90,110,140,115.266303393212,50
1411,1998,92,123,136,121.849545147124,44
1411,1999,85,108,128,111.652665577646,43
1411,2000,87,113,137,116.137254893661,50
1411,2001,92,116,143,120.385469875939,51
1411,2002,95,121,150,124.587662693854,55
1411,2003,85,106,134,113.275992439503,49
1411,2004,96,121,136,121.610287231593,40
1411,2005,87,108,137,115.497470487915,50
1411,2006,85,109,128,112.049375454368,43
1411,2007,89,121,155,122.859090903049,66
1411,2008,85,114,143,119.320261403634,58
1411,2009,84,100,141,110.666666651724,57
1411,2011,87,127,151,126.394781646378,64
1411,2013,108,132,150,131.777777751834,42
1411,2014,93,108,134,116.112094396997,41
1411,2015,97,116,141,118.677768858147,44
1412,1998,91,111,136,113.341736077521,45
1412,1999,85,110,128,110.38360567285,43
1412,2000,87,117,137,116.179839172018,50
1412,2001,86,116,136,114.257142850082,50
1412,2002,85,118,141,118.172406854302,56
1412,2003,85,106,134,113.389952145379,49
1412,2004,88,116,136,117.877434485957,48
1412,2005,87,119,138,116.701492536617,51
1412,2006,85,109,128,110.18674512412,43
1412,2007,80,115,147,116.211009113074,67
1412,2008,85,114,141,119.217889907317,56
1412,2009,84,100,137,107.658402195653,53
1412,2011,93,121,151,123.457309750744,58
1412,2013,108,123,150,130.441830050238,42
1412,2014,85,115,135,115.641711233651,50
1412,2015,92,116,143,118.696726905334,51
1413,1998,89,119,137,118.807692290714,48
1413,1999,82,103,121,107.425287341539,39
1413,2000,88,110,127,111.24434388195,39
1413,2001,86,100,122,107.999999991158,36
1413,2002,85,118,136,115.776307654349,51
1413,2003,86,109,127,108.585106382938,41
1413,2004,96,110,138,116.620657205586,42
1413,2005,88,111,133,113.82278481172,45
1413,2006,89,102,131,110.024624722465,42
1413,2007,80,100,127,108.747899156017,47
1413,2008,72,111,132,108.65984778073,60
1413,2009,83,96,125,102.95999998507,42
1413,2011,88,110,137,112.695203311607,49
1413,2013,105,123,136,123.936363634747,31
1413,2014,78,103,126,107.54623375388,48
1413,2015,80,102,124,106.800137339449,44
1414,1998,116,129,152,134.820353337835,36
1414,1999,101,120,134,122.868603627951,33
1414,2001,99,120,149,125.999762827965,50
1414,2002,109,134,156,136.239992699542,47
1414,2003,87,125,135,121.435967298291,48
1414,2004,101,129,143,128.561101441789,42
1414,2005,101,129,150,130.794312519501,49
1414,2006,99,120,159,128.039067771358,60
1414,2007,106,147,162,142.208661519179,56
1414,2008,112,126,152,132.88118812008,40
1414,2009,88,129,151,127.96051019879,63
1414,2011,95,127,155,132.092949853916,60
1414,2013,100,137,155,135.157086584008,55
1414,2014,100,120,142,124.316956179791,42
1414,2015,95,129,154,129.229588437496,59
1415,1996,117,125,144,131.214468721242,27
1415,1997,32,78,130,85.711384650786,98
1415,1998,78,130,165,129.667813301316,87
1415,1999,53,102,144,104.710045146824,91
1415,2000,67,109,151,113.184746823544,84
1415,2001,46,102,158,106.148684180601,112
1415,2002,106,137,172,140.829834485996,66
1415,2003,84,100,114,102.346135813219,30
1415,2004,96,133,144,127.66093831072,48
1415,2005,88,102,145,112.845557389964,57
1415,2006,88,102,123,106.551821405373,35
1415,2007,75,102,131,105.64774018344,56
1415,2008,78,112,129,110.130448725992,51
1415,2009,79,92,121,97.8987323323322,42
1415,2011,62,102,154,107.633748648528,92
1415,2013,98,107,123,111.228717657527,25
1415,2014,78,94,115,97.4004051101274,37
1415,2015,102,109,123,112.642479959734,21
1419,1991,85,119,141,119.678285512673,56
1419,1992,81,109,122,108.070390242383,41
1419,1993,81,102,132,107.329056101588,51
1419,1994,88,106,130,111.044975653328,42
1419,1995,88,99,125,105.368183247244,37
1419,1996,77,109,144,111.769427840708,67
1419,1997,60,102,144,103.703790707587,84
1419,1998,88,110,128,112.443233200509,40
1419,1999,87,100,124,106.575412418954,37
1419,2000,88,117,137,117.632197841761,49
1419,2001,88,107,130,111.702898957876,42
1419,2002,84,106,137,113.327624750255,53
1419,2003,78,98,126,102.657168143743,48
1419,2004,79,104,119,104.189503417057,40
1419,2005,81,103,113,105.034911942752,32
1419,2006,82,95,123,105.544815267098,41
1419,2007,73,109,134,108.095303413919,61
1419,2008,84,105,130,110.319129498705,46
1419,2009,85,104,127,106.182437243762,42
1419,2011,75,98,130,104.63002004034,55
1419,2013,98,116,137,118.817492957387,39
1419,2014,84,108,135,108.813813268755,51
1419,2015,92,107,130,114.983952751364,38
1420,2001,88,107,130,110.60723173297,42
1420,2002,84,106,137,111.556376020191,53
1420,2003,78,101,126,105.576923778703,48
1420,2004,79,104,124,107.249139785261,45
1420,2005,88,103,125,108.837874149125,37
1420,2006,78,102,130,107.220025245954,52
1420,2007,73,98,123,99.4895642527822,50
1420,2008,81,99,126,103.191845799854,45
1420,2009,78,92,123,99.7524881763745,45
1420,2011,67,96,123,99.4570377649654,56
1420,2013,91,109,129,114.342730148164,38
1420,2014,84,93,120,102.652419737692,36
1420,2015,86,100,130,110.340018897487,44
1421,2008,137,152,165,155.613761951676,28
1422,2001,90,106,127,110.129909300542,37
1422,2002,86,107,143,117.015121711615,57
1422,2003,81,96,127,104.001697740561,46
1422,2004,85,110,130,112.495453291631,45
1422,2005,82,103,131,107.634849793422,49
1422,2006,67,95,123,102.20739627204,56
1422,2007,76,112,139,112.29255633932,63
1422,2008,87,118,145,118.284074841674,58
1422,2009,74,101,138,107.716084458207,64
1422,2011,75,112,143,111.292298944061,68
1422,2013,102,117,137,120.63299554445,35
1422,2014,73,95,125,102.334606512385,52
1422,2015,85,109,130,110.538580439675,45
1423,2001,92,118,136,116.684401992241,44
1423,2002,97,120,134,120.063978668324,37
1423,2003,86,101,129,109.442857131798,43
1423,2004,83,109,127,112.018954260333,44
1423,2006,90,109,137,115.135244144372,47
1423,2007,95,126,147,122.732229664508,52
1423,2011,84,109,141,115.711602028762,57
1423,2013,97,115,145,122.846635503118,48
1423,2014,78,105,126,105.479583319112,48
1423,2015,88,94,116,104.289735696585,28
1424,2000,89,103,131,108.366197188598,42
1424,2001,85,106,127,110.492063459586,42
1424,2002,85,104,129,111.45161287963,44
1424,2003,84,102,116,101.739974315105,32
1424,2004,76,101,133,105.887242055313,57
1424,2005,81,102,130,108.306677098737,49
1424,2006,58,95,123,95.9456557241306,65
1425,2000,80,98,122,103.511764680085,42
1425,2001,80,106,127,109.234177189195,47
1425,2002,85,104,123,108.496240596715,38
1425,2003,78,96,120,101.181588302116,42
1425,2004,76,95,133,101.38455769104,57
1425,2005,88,102,116,106.2850568424,28
1426,2000,80,108,121,106.527712373028,41
1426,2001,80,104,115,103.332954881078,35
1426,2002,87,105,107,102.999999779197,20
1427,2001,85,107,127,107.862535936272,42
1427,2002,87,116,130,114.492685339192,43
1427,2003,74,95,118,101.37905761757,44
1427,2004,93,114,127,114.548996080074,34
1427,2005,78,99,127,105.4537220837,49
1427,2006,84,105,123,106.443642835946,39
1427,2007,83,104,118,104.226081265115,35
1427,2008,81,102,123,104.756299931845,42
1427,2009,80,94,131,101.236477308628,51
1427,2011,84,106,141,109.174660816818,57
1428,2003,78,99,120,102.108747792614,42
1428,2004,83,101,120,104.913817704771,37
1428,2005,85,99,120,103.315975938805,35
1428,2006,86,102,114,105.607393925614,28
1428,2007,71,94,116,98.9847727050248,45
1428,2008,84,104,115,103.500000013787,31
1428,2009,79,85,100,91.7159347484875,21
1429,1999,95,116,137,116.023942648919,42
1429,2000,90,110,137,113.627438110575,47
1429,2001,85,120,151,122.965111377017,66
1429,2002,102,123,137,122.516705260631,35
1429,2003,67,101,129,106.157586870681,62
1430,2003,81,99,121,101.650561649585,40
1430,2004,90,110,132,112.602150519574,42
1430,2005,89,103,120,106.692780467117,31
1430,2006,88,104,116,105.481082049227,28
1430,2007,81,102,125,107.534012783539,44
1430,2008,78,92,113,101.104157624682,35
1430,2009,78,92,121,98.9696567422597,43
1430,2011,75,90,106,94.8654075405753,31
1430,2013,88,107,128,111.014996263134,40
1430,2014,67,102,151,108.482722520944,84
1431,2003,95,106,127,112.923173359824,32
1431,2004,82,104,119,105.374110964733,37
1431,2005,81,104,134,108.708706853123,53
1431,2006,81,96,116,99.7672051646046,35
1431,2007,95,137,151,131.774924912253,56
1431,2008,95,119,137,117.597587248155,42
1431,2009,90,101,140,113.052805402968,50
1431,2011,64,116,158,116.693999687623,94
1431,2013,92,108,133,115.829244168234,41
1431,2014,78,93,121,102.442496994654,43
1431,2015,102,109,123,113.937517216339,21
1432,2003,78,105,124,106.744553548212,46
1432,2004,90,109,130,112.156404877499,40
1432,2005,88,106,120,108.43920866005,32
1432,2006,85,102,119,104.367405446689,34
1432,2007,80,95,126,101.204535733198,46
1432,2008,87,112,128,111.276355508116,41
1432,2009,74,96,125,98.995672960533,51
1432,2011,70,88,115,93.4487430727679,45
1432,2013,96,109,123,111.369572587773,27
1432,2015,78,108,130,108.328456252122,52
1433,2003,81,106,132,108.84736514987,51
1433,2004,88,116,141,117.245406993401,53
1433,2005,88,109,129,110.879491470595,41
1433,2006,81,107,128,109.724388775019,47
1433,2007,88,110,135,114.329970623979,47
1433,2008,83,109,137,112.197258205711,54
1433,2009,88,109,136,114.045883499659,48
1433,2011,69,95,130,102.795743018059,61
1433,2013,100,126,137,123.080967099658,37
1433,2014,88,109,129,113.024431173282,41
1433,2015,67,109,151,113.11521255976,84
1434,2003,74,105,130,105.765450765165,56
1434,2004,81,110,137,113.084562711627,56
1434,2005,81,103,125,105.093028684472,44
1434,2006,60,109,151,111.235769346042,91
1434,2007,88,102,125,108.572679179833,37
1434,2008,84,102,137,111.065985079931,53
1434,2009,74,96,133,103.491217187464,59
1434,2011,70,96,131,102.893815600625,61
1434,2013,95,109,137,117.680924510157,42
1434,2014,88,116,137,116.277680370454,49
1434,2015,67,95,123,99.8185633665451,56
1435,2003,102,109,116,111.625000751125,14
1435,2004,53,102,144,102.268171665418,91
1435,2006,102,109,109,110.328242658661,7
1435,2007,110,124,130,123.333534387229,20
1435,2008,81,109,137,112.458137738435,56
1435,2009,53,95,137,96.232498120169,84
1436,2000,78,99,120,105.714285697804,42
1436,2001,79,101,121,102.949240678327,42
1436,2002,78,101,120,103.644839653018,42
1437,2003,96,116,137,119.545935301176,41
1437,2004,97,118,133,119.414717732927,36
1437,2005,95,126,151,127.616563026976,56
1437,2006,95,123,144,125.329311351455,49
1437,2007,98,126,154,129.137852953433,56
1437,2008,105,123,152,128.833431838061,47
1437,2009,89,131,153,129.179481840156,64
1437,2011,102,130,151,132.847821420534,49
1437,2013,103,124,150,130.239417463323,47
1437,2014,91,119,140,119.180729349368,49
1438,2004,90,102,140,110.8481839102,50
1438,2005,83,92,133,104.28301886749,50
1438,2006,83,94,106,98.8874999697402,23
1438,2007,69,85,103,89.5295540649921,34
1438,2008,78,105,121,105.881937824101,43
1438,2009,84,95,116,100.127137791956,32
1438,2014,82,102,128,108.918199410762,46
1438,2015,53,102,144,104.912597285059,91
1439,2001,67,102,137,105.879638934623,70
1439,2002,79,109,130,110.764957486759,51
1439,2003,81,96,124,103.778236423571,43
1439,2004,81,104,127,107.944977920625,46
1439,2005,80,95,120,102.188850027354,40
1439,2006,85,100,120,105.980374018875,35
1439,2007,79,102,128,106.051321408839,49
1439,2008,81,99,121,103.120509976559,40
1439,2009,76,92,125,100.171299842096,49
1439,2011,75,87,115,94.9575601294597,40
1439,2013,92,108,123,112.441196857198,31
1440,2002,79,102,123,106.109306519091,44
1440,2003,97,109,130,113.2411972314,33
1440,2004,92,114,136,119.688172040797,44
1440,2005,85,101,131,107.047093612472,46
1440,2006,85,107,127,109.653915893347,42
1440,2007,85,113,137,117.28288097778,52
1440,2008,89,111,132,111.777771830849,43
1440,2009,83,102,123,104.125711499604,40
1442,2004,88,107,121,109.060108198275,33
1442,2005,88,100,126,107.636240749623,38
1444,2004,81,92,123,103.53888016219,42
1444,2005,61,109,151,109.891734124106,90
1444,2008,81,88,102,93.2804841431027,21
1444,2011,51,94,137,101.152103453629,86
1445,2004,90,126,135,121.976478616647,45
1445,2005,85,102,118,106.087167675763,33
1445,2006,90,103,123,108.796935634825,33
1445,2007,74,102,132,106.718012516239,58
1445,2008,77,99,122,100.639235073892,45
1445,2009,64,108,151,111.389180448062,87
1445,2011,39,75,116,80.7316352671857,77
1445,2013,78,114,149,117.454250222477,71
1445,2014,77,107,144,112.924931448951,67
1446,2004,88,120,155,122.076166894278,67
1446,2005,75,109,151,113.009997745673,76
1446,2006,95,95,102,101.999999999972,7
1446,2007,99,109,109,109.034102842586,10
1446,2008,88,123,151,124.786965143827,63
1446,2009,76,91,104,94.1467143605492,28
1446,2011,60,110,151,110.040625388549,91
1446,2013,87,119,150,122.937580311283,63
1446,2014,71,112,151,113.569919784576,80
1447,2004,104,120,148,127.40905723916,44
1447,2005,68,102,138,104.45376800611,70
1447,2006,90,102,124,107.843424482872,34
1447,2007,82,110,144,115.374675710595,62
1447,2008,64,99,143,105.486769715015,79
1447,2009,80,97,116,102.239616251081,36
1447,2011,67,95,131,101.218911725467,64
1447,2013,92,123,137,121.599682340094,45
1447,2014,73,105,123,102.859569457492,50
1448,2004,78,102,117,103.948304157386,39
1448,2005,81,94,126,104.415567182816,45
1448,2006,102,109,123,115.401349890374,21
1448,2007,73,95,116,97.9698363350575,43
1448,2008,67,111,151,112.480230062298,84
1448,2009,74,98,126,100.936695684781,52
1448,2011,46,93,137,96.5794030344544,91
1448,2013,97,105,126,110.784226435525,29
1448,2015,82,95,110,98.9119149765947,28
1449,2004,81,104,130,105.774801009691,49
1449,2005,46,89,130,93.2739573191474,84
1449,2006,95,107,123,112.978531436682,28
1449,2008,74,102,133,106.849818068068,59
1449,2011,74,87,124,96.8657438621326,50
1451,2005,60,101,139,104.176929611202,79
1451,2006,85,109,143,116.431688282942,58
1451,2007,81,113,149,117.841045961438,68
1451,2009,81,116,151,120.291587791571,70
1451,2011,91,130,149,124.928643023536,58
1451,2013,104,126,158,130.272916502027,54
1451,2014,87,116,142,117.111631594613,55
1451,2015,86,109,150,117.312297865671,64
1452,2004,53,109,156,110.006981113397,103
1452,2005,97,112,125,112.024938936087,28
1452,2006,60,102,137,105.438217407626,77
1452,2007,75,110,125,106.547837175928,50
1453,2004,95,122,151,128.826363711727,56
1453,2005,87,137,150,126.556947300093,63
1453,2006,107,138,162,140.948946595475,55
1453,2007,109,146,162,143.980873805365,53
1453,2008,102,139,167,140.040462885444,65
1453,2009,84,124,152,124.264185024932,68
1453,2011,82,123,151,124.441583915767,69
1453,2014,108,121,145,124.506061833335,37
1454,1987,89,100,126,106.712741619735,37
1454,1988,84,102,121,106.53729963443,37
1454,1989,79,102,123,103.790976564782,44
1454,1990,65,98,138,103.754027392289,73
1454,1991,81,137,179,135.673947426456,98
1454,1992,71,88,104,89.6284699343512,33
1454,1993,46,88,130,91.3785837716527,84
1454,1994,85,102,115,104.51067828955,30
1454,1995,67,102,151,110.254444304356,84
1454,1996,88,110,130,112.560722468622,42
1454,1997,58,95,137,102.038603089321,79
1454,1998,67,99,137,103.497535256616,70
1454,1999,67,100,137,105.643907500905,70
1454,2000,81,102,122,107.361263086418,41
1454,2001,88,116,137,118.285160163905,49
1454,2002,53,105,151,106.945697857742,98
1454,2003,116,127,137,129.754328037055,21
1454,2006,81,102,126,104.24774062492,45
1454,2007,81,102,125,105.766089466067,44
1454,2008,74,105,136,108.064988147444,62
1454,2009,64,88,113,94.3613445069541,49
1454,2011,65,92,121,97.3783574589043,56
1454,2013,97,117,128,116.5060890799,31
1454,2014,82,103,124,103.958437188582,42
1454,2015,81,109,123,108.133379711472,42
1455,2007,60,102,135,102.494868352414,75
1456,2007,74,95,123,101.679648267103,49
1456,2008,84,96,132,105.815188758254,48
1456,2009,82,92,127,105.69682508126,45
1456,2011,75,102,137,106.773941524656,62
1456,2013,97,110,137,118.630746331168,40
1456,2014,80,105,130,106.871696381879,50
1456,2015,85,109,137,116.518150311012,52
1457,2001,81,107,129,108.415385234963,48
1457,2006,50,88,116,88.9130365783497,66
1457,2007,78,102,119,99.8237458022813,41
1457,2009,102,116,130,119.28085368644,28
1458,2008,92,119,147,124.24748678231,55
1458,2009,91,107,145,116.735446300426,54
1458,2011,90,112,141,115.012993282927,51
1458,2013,105,123,153,127.560761345224,48
1458,2014,88,116,144,119.696359081803,56
1458,2015,88,109,143,116.94616113334,55
1459,2008,71,119,158,121.334835949507,87
1459,2009,65,101,153,109.811855709249,88
1459,2011,51,88,123,90.1775850716194,72
1459,2013,100,108,134,120.387096795781,34
1459,2014,78,99,120,103.03333326916,42
1459,2015,85,109,129,111.158851370926,44
1460,2008,74,106,145,113.096439001361,71
1460,2009,87,101,124,111.218859448816,37
1460,2011,82,123,141,121.398420484828,59
1460,2013,100,108,130,113.56348135995,30
1460,2014,85,92,120,103.636898390877,35
1460,2015,85,100,124,105.814973444983,39
1461,2009,109,137,151,136.701096033547,42
1462,2009,81,121,144,122.440990875419,63
1463,2009,75,91,109,97.1062157995288,34
1463,2011,115,130,142,132.475072060557,27
1463,2013,67,116,158,118.312825171484,91
1463,2014,60,105,137,104.320303125303,77
1463,2015,89,108,130,111.648944678887,41
1464,2009,81,121,158,121.070766415541,77
1464,2011,82,123,165,123.583315231096,83
1464,2013,53,102,145,103.132783166534,92
1464,2014,60,95,137,101.815845807664,77
1464,2015,81,102,124,104.850994737566,43
1465,2009,60,101,151,107.713704736948,91
1465,2011,94,109,137,116.050575598094,43
1465,2013,97,116,130,118.732753683919,33
1465,2014,62,109,151,109.342577256059,89
1466,2011,81,96,137,106.812711301524,56
1466,2013,53,97,137,99.2500907372621,84
1466,2014,46,94,137,95.5277560770067,91
1466,2015,67,108,151,112.195205612789,84
1467,2013,60,108,151,110.73481981865,91
1469,2011,81,94,129,103.918380479145,48
1469,2013,97,111,140,120.17733755265,43
1469,2014,82,101,123,107.837195506544,41
1469,2015,87,109,131,111.767566721332,44
1470,2011,67,95,130,101.991559635672,63
1470,2013,107,123,142,126.450366348864,35
1470,2014,81,105,121,106.024028106728,40
1470,2015,85,116,137,115.989832702822,52
1471,2011,92,115,141,118.937837827121,49
1471,2013,95,107,134,117.257230514019,39
1471,2014,85,99,127,106.981682489828,42
1471,2015,86,109,137,113.053789476736,51
1472,2011,87,130,158,130.717484864764,71
1473,2011,74,109,144,113.828665532551,70
1474,2011,65,96,132,97.550472598305,67
1474,2013,96,107,136,114.890534038802,40
1474,2014,75,93,113,97.2145815245203,38
1474,2015,82,101,126,105.423633916583,44
1475,2013,86,113,134,115.002200851023,48
1475,2014,84,102,115,103.328352888911,31
1475,2015,76,90,113,96.8612207495578,37
1476,2011,81,101,122,102.764132541749,41
1476,2013,96,106,128,115.366515840512,32
1476,2014,88,103,121,105.640044557436,33
1476,2015,85,101,124,108.954781999018,39
1477,2011,53,95,137,98.9246050951017,84
1477,2013,88,114,144,119.897766520656,56
1478,2011,74,89,119,97.5739840984548,45
1479,2011,90,116,142,121.245377630289,52
1480,2011,76,102,146,110.966677604925,70
1480,2013,105,116,136,122.018835422767,31
1480,2014,86,102,121,107.629325993851,35
1480,2015,79,102,123,103.378340503805,44
1482,2011,113,141,162,143.591359666454,49
1482,2013,116,135,152,137.413598869686,36
1482,2014,100,120,150,128.064277490068,50
1482,2015,105,134,163,135.644954729599,58
1483,2011,81,102,130,107.742124264224,49
1483,2013,107,113,130,120.62675515684,23
1483,2014,74,116,158,117.747579017427,84
1483,2015,85,109,122,109.864372443615,37
1484,2013,96,124,141,121.863048184913,45
1484,2014,73,104,122,103.451826714332,49
1484,2015,91,101,122,107.852849053723,31
1485,2013,95,108,129,114.387852390595,34
1485,2014,81,114,143,114.376113386367,62
1485,2015,73,106,158,114.291561452139,85
1486,2013,97,112,133,116.292479878821,36
1486,2015,91,96,125,105.353365674154,34
1487,2014,101,125,142,124.338517365513,41
1487,2015,82,123,163,126.443152167644,81
1488,2014,86,109,130,113.835717769524,44
1488,2015,85,107,129,111.455740196062,44
1490,2015,85,100,127,105.376804300473,42
1491,2015,83,100,137,111.850421213339,54
1492,2015,91,101,130,109.408669169343,39
1493,2015,91,109,130,114.744839284335,39
1500,2008,86,102,132,106.134140634859,46
1500,2009,74,102,137,104.224551935367,63
1500,2011,62,90,121,95.0291942035029,59
1500,2013,98,112,137,117.940177379636,39
1500,2014,83,95,118,101.126019195889,35
1501,1997,94,111,136,116.693830591343,42
1501,1998,98,116,136,119.888434191021,38
1501,1999,81,104,130,107.346506252641,49
1501,2000,74,108,151,114.844562046666,77
1502,1997,92,115,136,119.560988726298,44
1502,1998,92,116,136,119.994169162567,44
1502,1999,86,109,130,110.999494260706,44
1502,2000,88,109,139,114.147188837683,51
1503,1990,81,94,110,97.1889999086977,29
1503,1992,84,97,124,105.757976725422,40
1503,1993,85,109,131,110.240145380957,46
1503,1995,77,109,151,115.420641725256,74
1503,1996,88,122,158,126.166647831273,70
1503,1997,80,114,151,117.850064600339,71
1503,1998,88,115,130,115.133001763547,42
1503,1999,86,100,120,106.776352083968,34
1503,2000,91,112,140,116.225907944785,49
1503,2008,86,112,130,114.195010448211,44
1503,2009,85,100,130,106.987293586247,45
1503,2014,78,100,121,102.311533092423,43
1503,2015,72,101,137,108.184195251777,65
1504,2003,74,101,136,106.546705517628,62
1505,1992,85,111,129,111.24697915276,44
1505,1993,60,95,123,96.4929764180237,63
1505,1994,89,111,130,112.782087852246,41
1505,1995,88,109,130,115.677704711855,42
1505,1996,95,109,133,116.278627650323,38
1505,1997,81,99,134,109.979290167633,53
1510,1995,87,116,137,118.503103256341,50
1510,1997,67,116,158,115.597295636466,91
1510,1998,99,129,141,128.620704609258,42
1510,1999,93,109,142,117.507292297401,49
1510,2000,53,102,144,104.631648986139,91
1511,1984,88,109,133,112.49412477958,45
1511,1985,102,115,130,118.900645950355,28
1511,1986,100,115,134,119.508813064796,34
1511,1987,96,109,129,113.64502867849,33
1511,1988,83,109,127,109.285520355867,44
1511,1990,74,95,115,97.2896821478761,41
1511,1991,101,116,134,121.292628575662,33
1511,1992,78,97,121,101.56652742495,43
1511,1993,82,99,124,103.521654964063,42
1511,1994,89,100,113,106.809849507491,24
1511,1995,85,111,127,110.382121127464,42
1511,1996,92,113,127,115.364999885372,35
1511,1997,79,99,120,104.379261440938,41
1511,1998,85,109,127,113.193693016975,42
1511,1999,86,100,121,106.388957802594,35
1511,2002,85,107,135,115.229762116575,50
1511,2003,60,99,144,104.236142552004,84
1511,2004,76,104,136,108.148471606476,60
1511,2005,85,106,130,112.178082191403,45
1511,2006,85,99,138,109.485487882392,53
1511,2007,80,99,123,104.491148815701,43
1511,2008,87,113,137,116.280050795952,50
1511,2009,78,107,137,111.891647841754,59
1511,2011,80,106,127,108.584551991957,47
1511,2014,79,105,127,108.053770017867,48
1511,2015,86,109,130,110.435133828936,44
1519,1984,102,119,136,123.243006164139,34
1519,1985,95,115,135,119.483776095606,40
1519,1986,94,116,140,117.486157569722,46
1519,1987,97,109,135,116.868268358703,38
1519,1988,95,118,137,118.61477115451,42
1519,1989,85,107,124,110.310872124382,39
1519,1994,96,110,130,112.892758535438,34
1519,1995,95,109,122,112.526105347989,27
1519,1996,95,113,130,116.727703056682,35
1519,1997,88,114,137,114.190271554319,49
1519,1998,92,111,134,116.760775921564,42
1519,1999,91,100,122,107.376573908608,31
1519,2000,88,116,137,118.191281748943,49
1519,2001,94,113,137,118.529989617549,43
1519,2002,88,117,137,117.904666329693,49
1519,2003,88,100,124,109.632943708887,36
1520,1992,78,102,123,104.681949881631,45
1520,1993,81,108,136,111.433545913989,55
1520,1994,101,113,130,117.586248669349,29
1520,1995,95,113,135,115.54298345833,40
1520,1996,102,114,121,116.199051444569,19
1520,1997,98,114,136,119.741060460103,38
1520,1998,104,116,136,120.886707269062,32
1520,1999,99,116,131,117.671928015339,32
1520,2000,92,108,133,114.55929239027,41
1520,2001,102,121,140,125.285007820872,38
1520,2002,95,118,120,116.847888279728,25
1520,2003,96,110,125,111.226287956876,29
1521,1992,97,107,129,115.336918138031,32
1521,1993,89,117,144,121.422306566816,55
1521,1994,101,113,136,119.215063920042,35
1521,1995,96,113,131,115.868265673744,35
1521,1996,101,114,127,119.134272384221,26
1521,1997,101,126,142,123.780857789579,41
1521,1998,104,116,136,122.266666539866,32
1521,1999,86,107,123,110.77777772984,37
1521,2000,91,112,134,113.73913040424,43
1521,2001,96,114,145,118.733831545191,49
1521,2002,95,118,136,118.408531690424,41
1521,2003,77,116,148,117.103023462159,71
1522,1992,97,107,129,113.595068357705,32
1522,1993,89,108,136,113.982970461442,47
1522,1994,97,113,130,115.266124473347,33
1522,1995,95,107,121,112.935078145673,26
1522,1996,102,114,140,121.591754822619,38
1522,1997,101,114,136,123.516156931812,35
1522,1998,110,116,136,123.690136648547,26
1522,1999,95,108,116,109.186580882819,21
1522,2000,103,120,143,127.597475381463,40
1522,2001,96,107,133,112.84883742906,37
1522,2002,95,118,129,117.529154110724,34
1522,2003,85,110,127,112.827255143659,42
1523,1992,86,107,123,109.889679531789,37
1523,1993,88,108,136,116.608757405968,48
1523,1994,93,111,130,114.462363328133,37
1523,1995,96,107,121,110.854570779534,25
1523,1996,101,114,127,117.191743952339,26
1523,1997,98,110,131,116.168590742282,33
1523,1998,104,116,127,117.34437823523,23
1523,1999,86,99,123,107.894675919344,37
1523,2000,91,112,134,115.624584675102,43
1523,2001,96,114,133,116.131907357251,37
1523,2002,95,118,136,119.557077016766,41
1523,2003,85,101,116,105.94807890289,31
1524,1994,92,110,130,114.619024761164,38
1524,1995,95,107,127,113.8873864054,32
1524,1996,96,113,138,120.741713198609,42
1524,1997,98,116,137,118.630058959343,39
1524,1998,80,123,158,123.236399215328,78
1524,2001,92,114,136,117.651756258793,44
1524,2002,95,113,135,116.633404261114,40
1524,2003,90,106,123,111.36159592064,33
1524,2004,104,115,136,121.185945185545,32
1524,2005,92,113,138,117.219045484452,46
1524,2006,89,107,130,111.26133559087,41
1524,2007,80,109,127,108.936983280306,47
1524,2008,92,113,137,119.593899230399,45
1524,2009,85,109,128,109.929251226068,43
1524,2011,88,102,120,106.992401597895,32
1524,2013,99,113,139,120.670948756548,40
1524,2014,85,105,122,106.381289642602,37
1524,2015,92,114,130,116.7014922848,38
1525,1989,91,95,110,100.401098412273,19
1525,1990,67,94,132,99.2496477081167,65
1525,1991,95,106,120,111.182942121248,25
1525,1992,76,102,118,103.84779936119,42
1525,1993,81,99,130,106.612842143074,49
1525,1994,95,116,137,118.891696962345,42
1525,1995,88,104,115,108.284439438132,27
1525,1996,99,121,138,123.937024909837,39
1525,1997,98,111,120,112.180508910397,22
1525,1998,91,104,123,108.223091827751,32
1525,1999,85,100,120,105.20869853679,35
1525,2000,81,109,133,109.338954741643,52
1525,2001,94,107,114,108.509645496214,20
1525,2002,67,102,130,104.031269532169,63
1525,2003,87,102,115,104.122699538744,28
1525,2004,89,120,146,122.378014353533,57
1525,2005,85,104,124,108.523866029831,39
1525,2006,84,103,130,106.581977525724,46
1525,2007,93,110,130,114.752659769552,37
1525,2008,88,106,130,111.541464382367,42
1525,2009,74,101,131,104.139864173797,57
1525,2011,76,113,158,116.663771379918,82
1525,2013,100,115,141,121.876511620376,41
1525,2014,60,102,142,104.336493954837,82
1525,2015,87,112,130,115.625672071299,43
1526,1987,46,91,122,89.5802251098498,76
1526,1988,91,102,130,109.146575776572,39
1526,1989,84,95,116,101.3252734877,32
1526,1990,81,102,114,104.660798263717,33
1526,1991,101,113,134,120.868442777911,33
1526,1992,84,95,116,101.748544568667,32
1526,1993,81,102,130,108.524566826487,49
1526,1994,88,112,127,113.320554652925,39
1526,1995,95,101,122,108.228222071507,27
1526,1996,101,116,127,119.736289175827,26
1526,1997,88,110,130,109.648801174416,42
1526,1998,99,126,135,123.09915149868,36
1526,1999,88,102,121,107.933464695211,33
1526,2000,88,109,139,114.578840661937,51
1526,2001,100,116,123,117.395281024009,23
1526,2002,86,113,144,116.742532923044,58
1526,2003,87,109,127,112.254585589351,40
1526,2004,102,120,147,124.949430057396,45
1526,2005,88,112,130,110.868646548074,42
1526,2006,89,109,137,114.433521939897,48
1526,2007,88,115,144,119.655179039126,56
1526,2008,86,112,137,112.347769870448,51
1526,2009,85,116,137,118.906590962776,52
1526,2011,81,99,137,108.687747188551,56
1526,2013,92,113,142,119.733302235764,50
1526,2014,74,100,129,107.280357638163,55
1526,2015,87,107,137,116.703445379399,50
1528,1999,91,109,134,113.809322797784,43
1528,2000,94,111,133,116.376087197651,39
1529,2004,88,109,130,112.65521454171,42
1529,2005,95,117,138,119.902667010664,43
1529,2006,77,115,158,119.15432818866,81
1529,2007,89,100,121,105.769230770449,32
1529,2008,92,113,130,114.644289034455,38
1529,2009,85,107,127,110.627450990919,42
1529,2011,88,113,134,114.307469733361,46
1529,2014,23,39,60,44.7240170459134,37
1529,2015,95,102,107,104.451325877539,12
1530,2000,88,109,127,110.881808318291,39
1530,2001,93,114,132,116.703703700352,39
1530,2002,81,107,135,111.869714775985,54
1532,2003,86,129,157,126.996326636914,71
1533,2001,87,100,132,109.355848647319,45
1533,2003,73,101,136,106.273428062328,63
1533,2004,95,127,151,128.317246474434,56
1535,1997,81,123,165,125.505546635435,84
1535,1998,85,121,142,121.977720295607,57
1535,1999,81,97,102,96.8882501795006,21
1535,2002,46,102,150,100.725401698889,104
1535,2003,74,102,130,106.357984073504,56
1535,2004,90,113,146,118.773874317144,56
1535,2005,88,117,158,124.4197540359,70
1535,2006,73,108,151,114.782645207867,78
1535,2007,81,105,140,110.121621698229,59
1536,2004,95,119,137,120.469443221687,42
1536,2005,89,110,138,112.564107977877,49
1536,2006,89,110,136,113.7188137836,47
1536,2007,72,101,127,107.077154604174,55
1536,2008,85,106,137,111.414387309014,52
1536,2009,79,100,130,105.704651145977,51
1536,2011,76,95,139,103.559602650655,63
1536,2013,99,113,135,119.111559852596,36
1536,2014,83,103,129,106.900632322883,46
1536,2015,92,106,130,111.154652685586,38
1537,2004,83,111,133,109.948865999037,50
1537,2005,84,102,124,106.299862657442,40
1537,2006,88,102,123,109.400848731744,35
1537,2007,77,102,137,107.343205482829,60
1537,2008,80,116,144,116.8420684871,64
1537,2009,74,102,130,104.186963890274,56
1537,2011,67,96,137,102.292048422064,70
1537,2015,88,110,123,111.342755979235,35
1538,2005,85,107,127,109.718693538716,42
1538,2006,81,103,123,104.807683747487,42
1538,2007,82,104,124,106.20292002805,42
1538,2008,85,110,131,112.264509100181,46
1538,2009,80,93,119,102.715700334534,39
1538,2013,97,113,134,119.126988341298,37
1538,2014,81,102,124,104.17790888927,43
1538,2015,88,107,122,109.335067573306,34
1539,2005,87,101,132,107.476757366332,45
1539,2006,78,93,128,102.77745112022,50
1539,2007,74,102,122,104.070024165984,48
1539,2008,78,104,137,109.534596034016,59
1539,2014,79,102,130,105.553746623696,51
1539,2015,85,107,139,111.376884992864,54
1540,2005,83,107,130,111.065154714337,47
1540,2006,92,115,138,117.965578773932,46
1540,2007,105,126,137,124.975379297337,32
1540,2008,92,123,151,122.729917846746,59
1540,2009,83,95,125,103.019758116455,42
1540,2013,105,113,134,120.934036007242,29
1540,2014,87,99,122,106.81926228302,35
1540,2015,85,100,123,106.986638494473,38
1541,2005,75,102,120,105.597255163434,45
1541,2006,90,105,130,110.075255741036,40
1541,2007,74,94,123,99.694748248568,49
1541,2008,87,106,136,111.14388035624,49
1541,2009,73,92,128,103.070134314822,55
1541,2011,64,85,129,96.3783962702645,65
1541,2013,97,117,136,118.056380104077,39
1541,2014,80,103,127,106.2745168049,47
1541,2015,85,109,137,113.427533455987,52
1542,1988,109,109,117,115.521309042172,8
1542,1989,84,103,123,105.581895985854,39
1542,1990,77,102,132,102.733442158455,55
1542,1991,60,95,131,98.5601185069737,71
1542,1992,52,95,136,100.543673910628,84
1542,1993,81,109,136,111.553090696168,55
1542,1994,76,109,144,111.190996168216,68
1542,1995,82,95,133,100.357069132143,51
1542,1996,88,114,149,119.612019033226,61
1542,1997,88,102,120,106.283927541671,32
1542,1998,81,98,116,103.440751224738,35
1542,1999,85,100,120,104.53573838332,35
1542,2000,81,109,133,109.770471984525,52
1542,2001,66,102,136,102.802951539653,70
1542,2002,95,106,120,111.211840349466,25
1542,2003,95,106,127,113.946044429432,32
1542,2004,104,120,146,122.669600555661,42
1542,2005,85,104,130,108.88036034616,45
1542,2006,95,108,130,113.03573283047,35
1542,2007,81,93,123,101.53633833372,42
1542,2008,88,112,130,112.035762308171,42
1542,2009,77,92,116,96.9927244207063,39
1542,2011,64,113,158,117.652926829222,94
1542,2013,100,123,149,128.766105626128,49
1542,2014,85,113,134,115.167044726089,49
1542,2015,84,116,158,122.288157730564,74
1544,2005,92,105,121,108.814242010256,29
1544,2006,85,99,120,105.961240287156,35
1544,2007,92,106,120,110.945184050292,28
1544,2008,96,114,136,119.929414276083,40
1544,2009,83,102,120,105.204419827268,37
1544,2014,91,112,123,111.581844125823,32
1544,2015,85,100,120,102.525370242249,35
1545,2005,92,114,135,117.154611408313,43
1545,2006,99,106,127,116.046242785921,28
1545,2007,86,113,133,113.941176570724,47
1545,2008,96,114,136,121.485709368615,40
1545,2009,93,116,135,115.944904879767,42
1545,2014,96,116,131,117.621717116562,35
1545,2015,92,113,127,115.985021356925,35
1546,2006,83,94,109,98.6849877436821,26
1546,2007,90,110,123,110.365777970319,33
1546,2008,92,107,127,110.975195041063,35
1546,2009,83,90,107,96.1328161505085,24
1546,2011,84,102,123,105.320818190702,39
1546,2014,81,103,120,106.138063425897,39
1546,2015,86,108,129,112.118192144198,43
1547,2007,88,110,134,114.067804902068,46
1547,2008,92,109,128,113.596659846729,36
1548,2011,95,120,137,121.047032054245,42
1548,2013,106,123,141,127.923749540219,35
1548,2014,92,107,134,113.428066444492,42
1550,2005,85,103,116,104.701006078508,31
1550,2006,60,94,123,97.3790620679595,63
1550,2009,83,92,116,99.4212658800028,33
1550,2013,98,107,115,109.148447063579,17
1551,2009,84,93,145,108.675923687486,61
1552,2011,74,102,137,109.455396953707,63
1552,2014,88,111,130,113.269600423453,42
1552,2015,88,102,133,108.624728110742,45
1553,2011,89,109,137,115.445464689457,48
1553,2014,81,102,137,111.621408256269,56
1553,2015,95,109,137,115.254306330644,42
1554,2014,81,100,128,106.595901632984,47
1554,2015,84,95,119,102.251164876125,35
1555,2013,101,123,143,127.196206023442,42
1555,2014,95,108,131,113.489359032352,36
1556,2013,96,101,115,106.0219642087,19
1556,2014,71,85,99,88.0472154040882,28
1556,2015,78,95,122,103.566972356755,44
1557,2014,85,106,137,110.847253796201,52
1557,2015,88,113,158,122.080351171396,70
1559,2014,83,94,107,99.8196270191644,24
1559,2015,85,101,116,104.633234093908,31
1560,2014,80,103,131,106.853035587457,51
1560,2015,78,109,151,116.820045627237,73
1561,2013,106,123,141,127.983522898487,35
1561,2014,85,99,127,107.813875488044,42
1561,2015,85,109,127,109.632162232267,42
1562,2013,95,109,130,114.821964851172,35
1562,2014,83,105,121,104.754797602313,38
1562,2015,74,102,130,105.341987820098,56
1563,2014,85,108,127,110.46023255703,42
1564,2014,100,120,156,127.393256097156,56
1564,2015,92,134,163,134.104646046612,71
1565,2014,88,116,144,117.61724802158,56
1565,2015,92,114,155,123.249037685186,63
1566,2014,81,97,116,101.12565710609,35
1566,2015,78,94,113,99.6969878382782,35
1567,2014,84,102,126,104.111297247109,42
1567,2015,84,101,123,103.289321061708,39
1568,2014,83,102,116,103.362620176685,33
1568,2015,92,109,130,111.004440377165,38
1569,2014,78,113,149,117.593192557977,71
1569,2015,83,95,109,100.899815492863,26
1570,2014,78,99,113,101.748203887566,35
1570,2015,81,109,137,113.757461176121,56
1571,2014,81,109,137,110.540824897814,56
1572,2014,67,102,137,104.848207349341,70
1572,2015,123,130,144,136.341759691478,21
1573,2015,91,116,143,121.447124906145,52
1574,2015,98,116,151,122.643122473946,53
1575,2015,92,101,131,110.314597698902,39
1576,2015,85,123,151,124.467340575416,66
1577,2015,84,112,129,109.529761901097,45
1578,2015,92,106,127,113.064508104325,35
1579,2015,78,112,143,114.827053321336,65
1580,2015,86,100,130,107.35336751213,44
1581,2015,82,102,132,109.230894024303,50
1582,2015,91,116,137,118.021914117118,46
1583,2015,86,102,125,108.494868427986,39
1601,2002,89,103,117,107.23987366748,28
1603,1994,93,108,128,113.466784956727,35
1603,1995,93,113,134,116.156512303594,41
1603,1996,101,117,137,121.29115885467,36
1603,1997,89,113,130,116.486464851258,41
1603,1998,95,115,127,116.048225902946,32
1603,1999,79,99,122,105.977199495157,43
1603,2000,87,110,127,113.635286900452,40
1603,2001,102,114,127,118.867486564596,25
1603,2002,90,118,130,113.575100273267,40
1603,2003,82,95,117,102.384930988438,35
1604,2000,89,108,120,109.932050102893,31
1604,2002,85,109,129,111.948555133656,44
1605,2000,87,108,126,112.828236733541,39
1605,2011,81,97,121,103.09226738619,40
1605,2013,98,109,119,111.921326231395,21
1605,2014,86,101,122,106.30351312047,36
1605,2015,86,102,122,106.953072239201,36
1606,2000,82,102,124,105.062924777999,42
1606,2002,87,110,130,111.912532016418,43
1606,2003,82,104,119,103.491658121137,37
1606,2004,82,104,130,109.133981696395,48
1606,2005,88,104,123,107.181477877875,35
1606,2006,89,103,115,105.943226669053,26
1606,2007,78,107,131,107.597789495495,53
1606,2008,85,112,133,114.004774919147,48
1606,2009,83,90,101,96.3988166606961,18
1606,2011,81,95,122,101.884146564878,41
1606,2013,97,109,120,110.259237888284,23
1606,2014,78,93,113,100.548972087765,35
1606,2015,85,102,128,106.270738413647,43
1607,1988,94,116,130,117.135415811242,36
1607,1989,81,105,123,106.564101036873,42
1607,1990,87,109,124,108.989101915519,37
1607,1991,112,124,138,127.357481087558,26
1607,1992,87,116,132,116.558801264026,45
1607,1993,88,109,136,114.561385148455,48
1607,1994,97,107,130,114.581414463418,33
1607,1995,93,111,130,115.23939201179,37
1607,1996,101,107,123,113.292178235156,22
1607,1997,81,110,131,110.351107210674,50
1607,1998,74,119,158,120.995664880927,84
1607,1999,89,109,130,110.738576227281,41
1607,2000,88,119,133,115.89012907339,45
1607,2001,95,111,129,116.710764910657,34
1607,2002,80,102,130,108.908561468452,50
1607,2003,82,105,117,103.138386056829,35
1607,2004,89,112,133,115.323247527676,44
1607,2005,95,116,132,116.737487332536,37
1607,2006,91,112,126,113.248975289157,35
1607,2007,88,109,130,111.386363632814,42
1607,2008,91,119,132,116.813676095794,41
1607,2009,95,116,130,117.516068571923,35
1607,2011,90,109,137,114.512527335021,47
1607,2013,98,109,129,114.246048342023,31
1607,2014,86,112,126,109.568201742487,40
1607,2015,90,109,129,113.705253419218,39
1608,2000,80,116,151,116.896949859008,71
1608,2001,91,107,127,112.989471106391,36
1608,2002,98,117,133,118.463917519533,35
1608,2003,83,103,117,104.991271805842,34
1608,2004,97,115,129,117.617283944678,32
1608,2005,88,110,138,114.441860432971,50
1608,2006,81,105,119,104.887890426639,38
1608,2007,101,115,130,117.253709220372,29
1608,2008,92,114,135,117.948047234928,43
1608,2009,90,111,130,110.966975797465,40
1608,2011,81,96,119,101.152169515582,38
1608,2013,98,105,125,111.313679285949,27
1608,2014,76,88,109,94.5436507421103,33
1608,2015,88,102,124,109.363767595613,36
1610,1999,74,109,137,109.234321698652,63
1610,2000,80,116,151,117.157362639638,71
1610,2001,92,119,136,118.314005705163,44
1610,2002,85,111,133,114.903846161803,48
1610,2003,83,103,124,107.255777702143,41
1610,2004,88,115,136,117.459999977344,48
1610,2005,88,110,131,112.144578245759,43
1610,2006,83,105,126,104.582888044806,43
1610,2007,96,115,135,116.825743977531,39
1610,2008,92,121,143,121.589846462077,51
1610,2009,83,101,130,106.830446245044,47
1610,2011,88,109,129,111.38910951122,41
1610,2013,98,111,125,112.440831335336,27
1610,2014,76,93,116,97.5908164638132,40
1610,2015,88,110,124,111.480407105216,36
1613,2001,102,114,127,119.906140982301,25
1613,2002,85,109,120,110.467949752048,35
1613,2003,86,102,124,106.549970389942,38
1613,2004,81,108,127,111.18083384364,46
1613,2005,88,101,124,109.732702410809,36
1613,2006,94,104,116,108.085255191147,22
1613,2007,80,95,119,101.935181678704,39
1613,2008,92,111,130,115.513327166345,38
1613,2009,86,99,123,103.773219685623,37
1613,2011,81,94,116,98.2362176373497,35
1613,2013,96,109,126,112.260101974001,30
1613,2014,79,88,114,98.0437797109284,35
1613,2015,95,107,127,110.795723229671,32
1614,2000,88,111,127,113.114424493995,39
1614,2001,86,117,135,117.708372963497,49
1614,2002,79,101,124,106.442350980939,45
1614,2003,82,100,124,103.425075339089,42
1614,2004,86,110,128,112.279136581314,42
1614,2005,88,102,124,107.421182251902,36
1614,2006,87,101,120,107.717148189954,33
1614,2007,96,107,127,112.577093259666,31
1614,2008,95,114,128,115.326446281724,33
1614,2009,86,103,122,108.061757695941,36
1614,2011,87,102,131,110.313412125545,44
1614,2013,100,116,136,120.330442674356,36
1614,2014,93,114,135,117.860524734676,42
1614,2015,94,111,138,116.029271792246,44
1615,2007,77,116,159,119.269026371703,82
1615,2008,95,117,133,119.784677447279,38
1615,2009,84,101,130,108.611542246629,46
1615,2013,98,117,129,117.622285136327,31
1615,2014,84,105,120,107.797533783706,36
1615,2015,92,107,139,114.581201330226,47
1616,2009,84,93,130,106.784423721705,46
1616,2011,81,111,137,114.209659274514,56
1616,2013,100,107,131,116.620606229411,31
1616,2014,82,95,120,103.104970675025,38
1618,2015,85,102,124,108.697138339973,39
1701,1997,100,123,144,126.297835905615,44
1701,1998,95,131,141,126.062881173978,46
1701,1999,109,130,151,133.806917902374,42
1701,2000,102,122,144,126.82091051379,42
1701,2001,94,118,144,122.144392712731,50
1701,2002,113,128,149,132.87218700955,36
1701,2003,95,116,135,119.278397755849,40
1701,2005,88,106,138,115.776518898989,50
1701,2006,81,104,133,110.885753319635,52
1701,2008,92,119,137,121.971608928211,45
1701,2009,84,102,127,108.313951410074,43
1701,2011,95,116,132,118.273512234616,37
1701,2013,74,107,144,109.188648585953,70
1701,2014,43,85,137,93.269929340908,94
1703,2001,74,116,151,118.627132207183,77
1703,2002,102,123,142,124.437829345896,40
1703,2003,90,109,135,113.583929265917,45
1703,2004,80,116,144,115.094605918782,64
1703,2005,88,106,134,111.644456298936,46
1703,2006,90,106,127,110.911646565017,37
1703,2007,88,115,143,118.416666632621,55
1703,2008,92,123,150,125.684508293643,58
1703,2009,85,102,127,109.270554641011,42
1703,2011,95,114,142,120.264292657681,47
1703,2013,92,106,129,114.310809867826,37
1703,2015,79,101,116,102.642780149001,37
1705,1997,78,102,113,101.351189476408,35
1705,1998,81,100,122,104.610498540755,41
1705,1999,79,99,127,106.632129716457,48
1705,2000,81,97,120,102.920359046838,39
1705,2001,74,93,115,99.4215529829116,41
1705,2002,79,105,123,103.051094890358,44
1705,2003,73,93,115,98.0605228121933,42
1705,2005,75,97,119,98.4551311823292,44
1705,2006,68,88,122,95.2743381823964,54
1705,2007,74,95,117,98.4327744093185,43
1705,2008,84,95,120,103.412627272312,36
1705,2009,81,95,116,100.500386854609,35
1705,2011,70,87,123,95.4395409152231,53
1705,2013,92,109,128,111.704811604038,36
1705,2014,73,85,113,94.0719607401409,40
1705,2015,82,100,129,105.61513114418,47
1706,1995,88,111,129,111.372577256776,41
1706,1996,102,113,136,119.213515076555,34
1706,2001,93,116,142,119.171684736897,49
1706,2002,105,120,142,124.137686753062,37
1706,2003,94,116,136,116.714258653826,42
1706,2004,85,115,136,116.38874542579,51
1706,2005,94,113,138,116.659229207647,44
1706,2006,88,106,137,112.925717486526,49
1708,2002,87,111,139,115.0371379317,52
1708,2003,89,108,131,112.037888593579,42
1708,2004,80,109,136,112.431442673946,56
1708,2005,85,101,123,107.325516178153,38
1708,2006,86,102,116,105.112899245245,30
1708,2015,78,101,130,107.317051375031,52
1709,1993,85,107,127,109.571769565903,42
1709,1994,95,113,137,119.986764672819,42
1709,1995,96,111,122,112.50058603598,26
1709,1996,88,113,127,113.684928568851,39
1709,1997,91,101,122,107.801426400334,31
1709,1998,85,93,115,102.435483831061,30
1709,1999,85,107,130,109.487731658373,45
1709,2000,87,102,129,109.304022738953,42
1709,2002,85,99,125,107.767576109332,40
1709,2003,78,95,116,101.010829860123,38
1709,2004,80,102,120,104.147604077109,40
1709,2005,83,93,109,97.8199405991013,26
1709,2006,81,102,115,104.183870773937,34
1710,1998,88,116,137,118.008677923738,49
1710,2000,85,102,116,104.41217798561,31
1710,2001,107,123,144,128.582927116562,37
1710,2002,87,116,151,122.372396129873,64
1710,2003,82,115,158,122.559089477659,76
1710,2004,64,100,144,109.225155958488,80
1710,2005,95,116,144,122.935857479354,49
1710,2006,90,116,151,121.461578810659,61
1710,2007,74,95,123,101.02524034513,49
1710,2008,85,116,137,115.495918270962,52
1710,2009,80,109,144,115.566714315983,64
1710,2011,80,92,99,94.4822435265974,19
1710,2013,74,101,144,109.624944254816,70
1710,2015,93,116,144,121.325281692163,51
1714,2000,86,111,137,113.987047442949,51
1714,2002,95,108,127,113.318011721676,32
1714,2003,73,102,130,105.886760934865,57
1715,2001,85,109,136,114.253435610177,51
1715,2002,95,120,145,123.807520864572,50
1715,2003,88,106,129,111.739809307702,41
1717,2003,78,101,124,103.671126263768,46
1717,2004,65,94,115,97.0105819956575,50
1717,2005,79,94,123,100.256410265232,44
1717,2006,71,86,115,95.0351562274985,44
1717,2007,72,107,148,111.583166098745,76
1717,2008,78,103,137,106.694915243386,59
1717,2009,71,92,121,99.3821428462324,50
1717,2011,74,110,134,107.45999999206,60
1717,2013,79,102,128,106.55364805751,49
1717,2015,75,85,120,97.6350301131539,45
1718,2002,105,130,158,133.235016986725,53
1718,2003,88,116,137,116.982175083178,49
1718,2004,80,106,131,108.877633933226,51
1718,2005,88,109,134,114.539433300999,46
1719,2003,104,116,141,125.779109709625,37
1719,2004,77,113,158,116.775729815882,81
1720,2003,81,112,134,111.457020447494,53
1720,2004,75,97,136,104.456224290327,61
1720,2005,83,104,131,108.685358996351,48
1720,2006,81,93,124,103.41369750672,43
1720,2007,73,95,131,101.591044150896,58
1720,2008,72,106,144,111.755196298397,72
1720,2009,81,105,129,108.157588347622,48
1720,2011,75,94,137,105.424324053794,62
1720,2013,88,100,128,108.483387292718,40
1720,2014,80,93,122,102.036036035927,42
1720,2015,79,101,130,107.00646871241,51
1721,2003,86,97,97,97.0000000002219,11
1721,2004,108,136,165,140.932890621904,57
1721,2005,60,116,174,120.467819114941,114
1721,2006,123,123,128,127.985387071886,5
1721,2007,88,130,172,134.519723116149,84
1721,2011,89,116,141,121.19758001469,52
1721,2013,80,123,157,120.898220612077,77
1721,2014,46,92,135,93.074417684227,89
1721,2015,57,112,163,114.671861036504,106
1722,2002,111,134,149,134.597146835247,38
1722,2003,99,121,144,124.098576955326,45
1722,2004,95,117,145,122.561046397723,50
1722,2005,88,111,138,118.061521537213,50
1722,2006,90,109,139,115.372521305344,49
1723,2005,109,130,151,132.107015107297,42
1723,2006,82,103,126,105.3220796293,44
1723,2007,74,102,128,105.154516118878,54
1723,2008,74,88,116,94.0599072699818,42
1723,2009,60,95,137,102.348895729314,77
1723,2011,63,109,151,112.174363110719,88
1724,2003,84,95,116,102.009221254539,32
1724,2004,81,96,123,103.404431644135,42
1727,2005,95,119,145,119.913540780605,50
1728,2005,80,102,123,102.363046162546,43
1728,2006,76,103,130,106.139830047386,54
1728,2007,61,95,130,99.2248280681031,69
1728,2008,91,115,145,118.043442635387,54
1728,2009,64,93,121,96.9402640773943,57
1728,2011,74,92,130,102.930347223033,56
1728,2013,100,114,128,119.426943930667,28
1728,2014,85,101,113,102.575191301339,28
1728,2015,95,100,113,106.297869459838,18
1729,2006,96,117,135,119.448041319036,39
1730,2006,89,103,130,108.022283749945,41
1730,2007,81,116,144,117.710648208512,63
1731,2006,89,119,137,117.445786792474,48
1733,2007,73,97,121,98.9202843415714,48
1733,2008,84,102,129,106.339988911269,45
1733,2013,89,99,123,105.096884004834,34
1733,2014,74,93,115,98.2405268997929,41
1733,2015,80,94,116,101.456987460625,36
1734,2007,88,109,137,112.50318568238,49
1735,2009,74,113,158,118.104069025927,84
1735,2013,97,123,142,124.468981479225,45
1735,2014,80,106,127,106.915283226332,47
1735,2015,85,106,134,110.913216844446,49
1736,2008,99,126,143,125.07518229829,44
1736,2009,91,102,135,111.065538638553,44
1736,2011,117,137,155,139.29260682911,38
1736,2013,109,135,155,135.09773368235,46
1736,2015,86,109,137,114.402843965287,51
1737,2008,88,118,143,121.371087712123,55
1737,2009,81,94,130,105.051311886403,49
1737,2011,67,117,168,119.332259549591,101
1737,2013,102,130,158,132.76146380529,56
1737,2015,77,91,109,94.2089108277803,32
1738,2011,56,104,151,103.799999867887,95
1738,2013,89,109,137,115.565405472321,48
1738,2014,85,85,95,94.0840750936458,10
1738,2015,60,67,74,71.2079124791624,14
1739,2011,80,116,151,118.483733921581,71
1739,2013,96,113,143,121.765941750007,47
1739,2015,88,94,134,109.779903541465,46
1740,2011,61,104,137,103.959960314463,76
1740,2013,81,114,151,118.177440616326,70
1740,2014,67,88,109,91.5150074163974,42
1740,2015,80,101,137,109.01990511372,57
1741,2011,75,102,144,109.554000770007,69
1741,2013,88,107,130,109.335572938147,42
1741,2014,39,81,126,85.7339012581128,87
1741,2015,60,102,151,105.786464707712,91
1742,2011,82,109,143,114.669890769155,61
1742,2013,60,102,151,108.931862763909,91
1742,2014,93,109,123,111.623002729374,30
1742,2015,81,87,94,92.2123947746361,13
1743,2011,82,123,153,123.078341013823,71
1743,2013,95,110,132,113.814684777702,37
1743,2014,86,106,129,111.758849618548,43
1743,2015,85,109,128,112.44046282859,43
1744,2011,80,101,117,101.94317335611,37
1744,2013,91,101,123,107.728829330097,32
1744,2014,80,93,115,96.9082444820137,35
1744,2015,79,92,122,100.043656167433,43
1745,2011,82,114,136,113.496455694059,54
1745,2013,96,113,134,115.568446787446,38
1745,2014,79,102,120,102.755813953539,41
1745,2015,86,100,122,104.914116480256,36
1746,2011,84,113,143,120.664969811371,59
1746,2013,81,115,150,119.613653866228,69
1746,2014,93,116,137,117.74667171562,44
1746,2015,90,116,134,115.989559138653,44
1747,2013,120,137,149,139.344924884522,29
1747,2015,84,109,144,113.372499635221,60
1748,2013,96,116,144,120.330044463685,48
1748,2014,78,101,128,108.706877483171,50
1748,2015,85,101,122,108.200673303439,37
1751,2013,80,99,123,102.48783543583,43
1751,2014,81,102,113,102.553261533641,32
1751,2015,46,101,151,101.474487270033,105
1752,2013,90,101,116,106.173223144649,26
1752,2015,95,112,116,111.334923900715,21
1753,2013,102,115,129,117.774195919012,27
1753,2014,81,104,130,107.643719580891,49
1754,2013,78,116,158,121.616268661337,80
1754,2014,39,88,137,91.7216911344228,98
1754,2015,84,100,128,107.393925628293,44
1755,2013,110,130,158,135.999864185361,48
1755,2014,34,78,120,82.9980691764449,86
1755,2015,84,100,116,102.130282877416,32
1756,2014,81,102,129,107.919984454755,48
1756,2015,84,109,130,109.348824979812,46
1757,2014,73,94,129,103.561609120225,56
1758,2014,78,101,128,104.839938812568,50
1758,2015,80,100,139,107.447735223925,59
1760,2015,80,85,108,95.271945896562,28
1761,2015,85,110,139,113.317508141033,54
1762,2015,84,100,123,105.031710285867,39
1763,2015,80,95,124,102.413089331378,44
1764,2015,85,99,115,103.927505202327,30
1780,2006,90,109,139,115.372521305344,49
1780,2007,97,116,156,124.946354312471,59
1780,2008,102,126,150,128.612782906428,48
1780,2009,85,109,140,113.709495500515,55
1780,2011,82,112,144,115.465429793071,62
1780,2013,96,110,144,118.183759363212,48
1780,2014,78,101,126,105.733216137598,48
1780,2015,79,101,130,108.769655879279,51
1803,1997,90,114,142,121.033805713043,52
1803,1998,94,129,151,127.923757547675,57
1803,1999,92,120,155,125.079447136494,63
1803,2000,85,113,144,119.754666460995,59
1803,2001,86,123,161,127.734292426999,75
1803,2002,111,130,162,138.296579520433,51
1803,2003,92,118,147,120.993952262557,55
1803,2004,95,131,151,130.048697925518,56
1803,2005,97,123,161,127.677396672211,64
1803,2006,98,123,148,126.020934214858,50
1803,2007,111,147,165,143.985326449746,54
1803,2008,94,129,166,133.72085887888,72
1803,2009,90,118,150,121.190659697372,60
1803,2011,112,136,158,137.359620084918,46
1803,2013,102,114,154,123.316841019136,52
1803,2014,78,106,141,113.83193316419,63
1803,2015,84,100,151,112.087786260912,67
1805,1999,94,106,134,114.261331355029,40
1805,2000,86,106,128,110.817079385651,42
1807,1999,85,106,136,111.335107431833,51
1807,2000,88,105,120,107.946282482821,32
1807,2001,91,103,120,107.781158852643,29
1808,1980,68,81,95,84.7794197559064,27
1808,1981,83,99,113,102.742786963581,30
1808,1983,94,116,137,118.087020912017,43
1808,1984,72,81,81,81.0000000000124,9
1808,1985,95,116,144,120.209770342787,49
1808,1986,67,109,144,111.760040395821,77
1808,1987,109,123,144,127.142466771235,35
1808,1988,109,116,123,120.533355142051,14
1808,1989,88,109,130,114.363180420008,42
1808,1990,102,116,123,116.184855074074,21
1808,1992,95,109,130,113.406551847522,35
1808,1993,109,116,123,120.958237372303,14
1808,1994,88,116,144,119.315125361151,56
1808,1995,99,116,144,122.990000127942,45
1808,1996,109,116,123,121.629748690132,14
1808,2001,84,109,137,114.161375704049,53
1808,2002,94,116,137,117.983866264594,43
1808,2004,50,95,137,98.0973678581211,87
1808,2006,75,109,144,110.600898628097,69
1809,2001,84,109,137,112.409193415587,53
1809,2002,97,116,144,121.76366300682,47
1809,2003,60,100,151,107.880180057854,91
1809,2004,60,102,144,105.877687271044,84
1809,2005,81,109,129,110.272586473571,48
1809,2006,65,112,148,112.099920757864,83
1809,2007,39,95,137,95.0269730927323,98
1809,2008,95,109,130,115.432033613096,35
1809,2013,87,105,116,105.676464643114,29
1809,2014,62,99,151,106.741210142706,89
1809,2015,66,102,144,107.886983882006,78
1811,2000,85,120,165,127.315434175679,80
1811,2001,89,118,151,123.512019841333,62
1811,2002,100,130,151,131.519793631671,51
1811,2003,95,116,130,118.970530985624,35
1811,2004,85,118,144,119.594327762132,59
1811,2005,81,99,133,106.198097451779,52
1811,2006,91,108,126,109.949087861913,35
1811,2008,95,114,137,119.97762878107,42
1811,2011,81,116,155,121.515955226535,74
1811,2013,88,116,137,117.259076569495,49
1811,2014,84,112,137,112.605860320531,53
1811,2015,67,116,158,115.589134142003,91
1813,2001,74,99,135,107.875358735045,61
1813,2002,108,138,148,137.103188663302,40
1813,2003,94,114,136,118.483923249948,42
1813,2004,85,106,136,115.725658860652,51
1813,2005,95,116,137,118.055458553925,42
1813,2006,89,109,139,113.928168002757,50
1813,2007,98,124,145,124.515796226821,47
1813,2008,99,129,146,129.104197257349,47
1813,2009,92,118,138,120.112612594864,46
1813,2011,91,126,143,126.981283811739,52
1813,2013,106,131,144,128.579792916963,38
1813,2014,88,116,131,116.283895008047,43
1813,2015,86,112,137,115.623048910031,51
1820,2005,98,116,143,121.13085033795,45
1820,2006,84,106,137,111.178885519634,53
1820,2007,88,109,159,121.29938073417,71
1820,2008,84,106,136,110.739634475777,52
1820,2009,81,96,127,103.464597898008,46
1821,2009,82,103,133,107.353270179682,51
1821,2011,109,132,151,135.336497788176,42
1821,2013,95,109,144,117.424103024153,49
1821,2014,60,106,152,107.853340249205,92
1821,2015,79,109,134,110.928337025016,55
1823,2009,60,81,109,87.4918222736532,49
1824,2009,85,102,123,105.249014791548,38
1825,2009,60,90,122,93.834127773528,62
1826,2009,64,101,130,101.254874513323,66
1827,2011,94,136,163,135.876304891496,69
1827,2013,100,114,154,125.089540100641,54
1827,2014,85,119,148,119.892501455275,63
1827,2015,91,118,159,123.802961035411,68
1828,2011,95,125,151,127.770055556315,56
1829,2011,93,123,143,124.768310675949,50
1830,2011,74,117,155,116.734118794231,81
1830,2014,78,101,130,104.725137697219,52
1830,2015,79,101,123,102.284533245323,44
1831,2011,75,95,132,104.28332637039,57
1832,2013,95,110,130,116.27671893768,35
1832,2014,78,106,127,108.109223248789,49
1832,2015,53,101,144,102.841949551475,91
1833,2011,82,112,136,112.314344530404,54
1834,2011,67,74,81,77.7886836558141,14
1835,2013,92,116,130,115.810661042856,38
1835,2014,72,88,109,92.0337500482648,37
1835,2015,66,116,162,118.71220224518,96
1836,2013,87,100,129,108.594417875352,42
1836,2014,80,93,115,99.2719395849041,35
1836,2015,96,107,123,111.357205991431,27
1837,2013,98,116,140,120.035325868158,42
1837,2014,85,112,129,112.570700608711,44
1837,2015,85,108,144,115.481181586263,59
1838,2013,95,123,151,127.38931368553,56
1839,2013,92,106,128,113.756262335516,36
1839,2014,85,101,122,105.163988993021,37
1839,2015,85,101,130,107.795414020475,45
1840,2013,96,109,128,117.546426284568,32
1840,2014,90,109,130,111.011338286622,40
1840,2015,95,108,134,114.972459248708,39
1841,2013,92,110,130,116.492040042275,38
1841,2014,83,111,126,109.203286049674,43
1841,2015,91,108,134,112.688099712454,43
1842,2013,101,132,158,131.014708938052,57
1842,2014,57,105,144,103.421817523551,87
1842,2015,67,109,155,112.927530038891,88
1843,2014,72,85,111,93.0095314034684,39
1843,2015,76,90,109,95.4735560211282,33
1844,2014,67,95,126,97.7555958231116,59
1844,2015,74,121,158,119.508303664845,84
1845,2014,88,100,121,106.215727664229,33
1845,2015,82,99,130,108.371017245134,48
1846,2014,74,92,130,102.484521897301,56
1846,2015,81,109,140,113.123924172795,59
1847,2014,78,93,114,101.043563128363,36
1847,2015,86,101,122,109.586860191899,36
1848,2015,79,110,137,112.300961073722,58
1849,2015,90,101,137,111.741490769865,47
1850,2015,76,96,116,100.328749522385,40
1851,2015,81,109,133,112.085557680644,52
1852,2015,102,116,137,122.360316133379,35
1900,1996,76,106,137,108.981370674923,61
1900,1997,75,109,127,105.850067031636,52
1900,1998,96,109,124,114.666510772403,28
1900,1999,101,117,128,116.693590229981,27
1900,2000,102,109,122,113.662673415645,20
1901,1993,88,109,135,113.30824702461,47
1901,1994,93,114,128,114.586878372823,35
1901,1995,86,100,120,105.671850170452,34
1901,1996,88,104,125,110.164430622755,37
1901,1997,92,110,129,113.546626312096,37
1901,1998,88,110,123,111.346239935358,35
1901,1999,87,99,121,106.445347145723,34
1901,2000,86,106,129,109.126713008968,43
1901,2003,82,98,116,101.65216124915,34
1901,2006,85,102,123,106.131818366079,38
1901,2008,83,102,123,108.857477981634,40
1901,2009,74,95,123,99.8593033487036,49
1901,2011,70,95,122,100.656806581882,52
1901,2013,90,118,151,123.076635126617,61
1901,2015,79,95,124,102.360113137881,45
1902,2006,83,95,116,101.23429063333,33
1902,2007,80,104,123,105.856271383425,43
1902,2008,84,109,137,112.358661955929,53
1902,2009,81,95,130,104.929241723765,49
1903,1990,77,101,106,97.2225312175595,29
1903,1991,98,118,132,119.602919412176,34
1903,1992,64,87,118,94.5544111803543,54
1903,1993,80,104,137,108.133581347654,57
1903,1994,91,108,128,109.453932379695,37
1903,1995,74,107,142,111.734115038513,68
1903,1996,98,112,125,114.380417632332,27
1903,1997,88,111,129,112.154542226186,41
1903,1998,102,122,139,122.18880391051,37
1903,1999,88,109,133,112.806497123038,45
1903,2000,94,111,130,113.560315261976,36
1903,2001,92,106,130,113.185245273412,38
1904,1997,62,109,158,112.44830003113,96
1904,1998,96,116,144,122.246272043556,48
1904,1999,87,99,129,108.093331049154,42
1904,2000,95,116,127,119.330693247793,32
1904,2003,75,98,130,102.073969576473,55
1904,2006,91,109,137,114.959207903741,46
1904,2007,74,110,150,115.837749670261,76
1904,2008,95,121,144,124.618870565298,49
1904,2009,84,109,141,113.555222860869,57
1904,2011,82,123,151,121.299762164486,69
1904,2013,95,116,142,122.267974729425,47
1904,2014,78,100,120,102.513491394695,42
1905,1988,90,109,127,112.853178632788,37
1905,1989,80,85,106,95.0451540114308,26
1905,1991,101,118,130,121.084930638635,29
1905,1992,82,103,133,109.235911082298,51
1905,1993,87,109,123,110.287736779618,36
1905,1994,93,109,121,109.680445163966,28
1905,1995,86,99,113,104.647003513339,27
1905,1996,97,106,122,114.748388194763,25
1905,1997,81,100,120,105.15638405285,39
1905,1998,95,110,127,114.124862021275,32
1905,1999,75,94,114,94.8253416474537,39
1905,2000,95,110,127,113.497896538011,32
1905,2001,95,103,123,110.328353125294,28
1905,2002,85,104,123,107.604884138725,38
1905,2003,82,97,117,100.642242713806,35
1905,2004,86,102,120,106.695636609943,34
1905,2005,85,101,124,106.226272930615,39
1905,2006,90,102,115,106.32523757269,25
1905,2007,74,95,112,95.7585136404919,38
1905,2008,80,92,117,100.546581090132,37
1905,2009,82,95,111,97.2725700106753,29
1905,2011,72,87,106,92.7054703669616,34
1905,2013,97,109,125,113.94334600383,28
1905,2014,83,95,113,99.466573179202,30
1905,2015,90,100,116,106.171811575117,26
1906,1996,96,108,122,112.068224703233,26
1906,1997,85,106,128,110.301573948542,43
1906,1998,98,110,123,111.668993699713,25
1906,1999,89,100,120,108.16237408336,31
1906,2000,95,118,137,118.281233736565,42
1906,2006,89,99,121,105.582412784422,32
1906,2007,80,95,113,100.037132281563,33
1906,2008,87,106,133,110.051033008933,46
1906,2009,82,86,106,94.8038791221782,24
1906,2011,72,87,131,99.8533333428151,59
1906,2013,109,123,144,127.698183719177,35
1906,2014,82,88,115,97.4354785857362,33
1906,2015,79,96,116,101.09069773547,37
1907,1998,79,106,127,108.228627520978,48
1907,1999,79,99,122,102.299453553584,43
1907,2000,80,99,122,104.989253485198,42
1907,2001,92,107,122,110.886555462671,30
1907,2002,85,105,133,108.372080103819,48
1907,2003,81,100,131,105.333017050657,50
1907,2014,74,103,117,101.689411936419,43
1907,2015,81,98,122,103.931735629759,41
1908,1998,74,102,122,101.480698450555,48
1908,1999,81,93,117,98.8238703401029,36
1908,2000,90,102,117,106.085545446359,27
1908,2003,82,98,122,101.792004927506,40
1908,2006,84,95,116,103.591967693317,32
1908,2007,84,97,116,101.645322640184,32
1908,2008,84,102,116,102.705718910997,32
1908,2009,46,88,130,92.4175655120345,84
1908,2011,74,95,109,96.1633588790165,35
1908,2014,82,88,95,92.8833998238408,13
1909,1996,94,106,125,112.111269591484,31
1909,1997,97,113,128,114.922364783324,31
1909,1998,94,111,122,112.098230148755,28
1909,1999,85,102,120,104.935356950201,35
1909,2000,93,110,121,111.608654367849,28
1911,1996,95,116,132,118.204262743398,37
1911,1997,96,110,125,112.699450850564,29
1911,1998,89,110,123,111.102614821996,34
1911,1999,87,102,122,106.958278933715,35
1911,2000,81,102,128,106.837425898049,47
1911,2006,84,104,127,107.821380119547,43
1911,2007,89,105,126,109.648561172814,37
1911,2008,89,109,128,113.952505150294,39
1911,2009,84,101,124,108.058898863193,40
1911,2011,84,101,123,103.682250178226,39
1911,2013,97,104,131,113.291654716185,34
1911,2014,82,98,114,101.63035264394,32
1911,2015,86,102,124,107.676315056501,38
1912,1996,91,109,133,112.259927188879,42
1912,1997,88,110,131,111.597945465805,43
1912,1998,88,109,137,115.54061886757,49
1912,1999,87,101,120,105.227368413358,33
1912,2000,88,109,127,112.236972093549,39
1912,2006,85,99,137,110.2360241199,52
1914,1996,88,101,123,107.869585404992,35
1914,1997,84,105,133,108.024930137306,49
1914,1998,91,111,136,117.05848957322,45
1914,1999,84,102,120,105.471663865837,36
1915,1999,92,102,116,106.33618344301,24
1916,1997,88,102,126,107.39965422111,38
1918,1996,93,109,127,114.760587992242,34
1918,1997,90,110,120,108.68078210333,30
1918,1998,104,115,128,119.479732364639,24
1918,1999,86,107,120,109.403361793471,34
1918,2000,88,107,129,109.70920029495,41
1918,2002,95,107,120,112.463898003034,25
1920,2006,89,99,113,102.180540295307,24
1920,2007,87,107,120,108.126760550812,33
1920,2008,85,106,123,106.813108954743,38
1920,2009,73,85,106,93.06484087321,33
1920,2011,68,85,106,90.2749575844683,38
1920,2013,96,106,120,110.11231688863,24
1920,2014,78,93,113,97.8927109854208,35
1920,2015,85,94,114,101.023071185567,29
1921,1996,87,108,126,110.33897483697,39
1921,1997,78,106,137,110.373870102649,59
1921,1998,99,116,131,119.171384268471,32
1921,1999,87,109,123,107.879252455513,36
1921,2003,96,109,121,109.384715102382,25
1922,1986,90,103,131,110.618298179573,41
1922,1987,89,113,137,116.299445466461,48
1922,1989,76,95,113,95.8726921241074,37
1922,1990,77,98,112,97.6843615603817,35
1922,1992,60,102,145,106.180749844903,85
1922,1993,81,102,136,111.433662484453,55
1922,1994,88,101,121,107.805491957536,33
1922,1995,86,99,114,103.388412864474,28
1922,1996,87,102,119,105.575469020855,32
1922,1997,81,100,113,101.475872244678,32
1922,1998,85,99,115,105.48357839192,30
1922,1999,85,94,114,101.060135998494,29
1922,2000,89,102,122,109.076023110215,33
1922,2001,88,103,117,106.883334277603,29
1922,2002,85,104,115,103.775794682767,30
1922,2003,75,97,111,96.073875373585,36
1922,2004,80,109,120,107.021181852336,40
1922,2005,80,92,106,98.3634743266754,26
1922,2006,90,102,115,102.968625145387,25
1922,2007,78,88,112,94.0809698095891,34
1922,2008,79,92,111,100.979606704461,32
1922,2009,74,86,111,93.0093772635337,37
1922,2011,72,81,101,87.5095032254488,29
1922,2013,97,104,123,110.938345428364,26
1922,2014,83,95,113,101.572267249402,30
1922,2015,79,95,116,100.347040332068,37
1925,1999,95,109,144,119.465026036897,49
1925,2000,89,104,132,110.848561629865,43
1925,2006,81,99,120,103.917096266419,39
1925,2007,87,107,134,113.370370343676,47
1925,2008,92,106,128,111.788045345919,36
1925,2009,82,85,106,94.7143370185266,24
1925,2011,81,94,122,103.23205373519,41
1925,2013,99,113,141,117.246070323542,42
1925,2014,73,90,120,97.4366350176239,47
1925,2015,81,94,107,96.5353544950441,26
1926,2006,77,101,137,109.321708965389,60
1926,2007,87,107,137,112.769230694441,50
1926,2008,92,113,138,116.698856379354,46
1926,2009,85,95,138,102.615872278006,53
1926,2011,74,102,149,109.296865870019,75
1926,2013,99,113,141,119.577733820283,42
1926,2014,78,93,127,100.843484930271,49
1926,2015,85,94,114,101.898287462979,29
1927,1999,81,95,138,105.480140260538,57
1927,2000,67,109,145,109.531907982211,78
1927,2006,81,94,107,97.895442801943,26
1927,2007,92,123,155,127.199999857859,63
1927,2008,85,113,144,116.410107836394,59
1927,2009,82,85,113,95.9680907910804,31
1927,2011,82,102,127,107.921125657231,45
1927,2013,92,106,127,112.635582427984,35
1927,2014,73,88,113,92.459610387136,40
1927,2015,81,94,129,104.463715092764,48
1928,2006,77,94,115,96.77381325728,38
1928,2007,81,104,113,102.875000056372,32
1928,2008,92,113,128,116.66913438491,36
1928,2009,82,85,127,97.2574738651516,45
1928,2011,74,94,122,99.1364535999638,48
1928,2013,92,106,127,113.999625658751,35
1928,2014,69,88,120,94.3335624696916,51
1928,2015,81,94,124,100.812848901501,43
1930,1998,91,109,132,113.827738988349,41
1932,1996,102,113,137,118.859363848264,35
1932,1997,71,99,128,105.561893353952,57
1932,1998,98,110,134,117.200913564203,36
1932,1999,86,108,128,112.814159294848,42
1932,2000,87,110,134,112.12906037601,47
1932,2001,100,119,127,118.524999994872,27
1932,2002,85,117,136,117.449907624676,51
1932,2003,81,106,127,108.47337276543,46
1932,2004,93,114,136,117.83124999342,43
1932,2005,85,106,120,108.729729720635,35
1932,2006,90,103,126,107.043795618378,36
1932,2007,80,105,127,107.144329657807,47
1932,2008,92,115,137,119.5060679959,45
1932,2009,82,101,127,108.307248208841,45
1934,2003,78,95,121,102.295201285442,43
1934,2006,81,95,121,103.876710164805,40
1934,2007,80,100,121,104.714727305159,41
1934,2008,89,112,121,109.872439337457,32
1934,2009,82,100,123,103.074868779018,41
1935,1996,102,116,130,117.042470326946,28
1935,2003,82,110,131,109.843905624749,49
1935,2004,103,122,136,126.766263515899,33
1935,2005,93,106,135,112.620369093198,42
1935,2006,85,106,127,109.247955617277,42
1935,2007,78,112,147,116.633692574346,69
1935,2008,92,130,144,126.156542495086,52
1935,2009,93,114,141,118.774859347468,48
1935,2013,100,115,128,116.354069789094,28
1935,2014,78,92,113,99.1596761727243,35
1935,2015,85,100,123,105.933049377524,38
1936,1997,93,110,128,113.312433541559,35
1936,1998,104,114,139,120.705637679952,35
1936,1999,93,107,120,111.726998853698,27
1936,2000,94,107,129,115.308754290913,35
1936,2001,95,112,127,114.230721818403,32
1936,2002,102,108,120,114.542618124896,18
1936,2003,86,100,113,103.701030278001,27
1936,2004,83,104,120,105.357149514501,37
1937,2006,83,102,130,108.934460842681,47
1937,2007,80,104,123,106.027827661115,43
1937,2008,84,102,133,107.922409891667,49
1937,2009,82,97,125,103.518688498444,43
1937,2011,75,93,131,100.555750766309,56
1937,2013,95,106,137,113.998599730643,42
1937,2014,78,98,123,101.67983478182,45
1937,2015,82,102,131,108.991942153177,49
1938,1995,74,91,110,98.1876645077378,36
1938,1996,85,106,127,107.255144642115,42
1938,1997,53,74,113,85.5417062727332,60
1938,1998,73,98,106,97.2469349440514,33
1938,1999,79,86,106,93.3752793738815,27
1939,1997,93,99,119,109.746156076177,26
1939,1998,88,104,126,111.110586297607,38
1939,1999,67,92,113,96.9948496418431,46
1940,1996,87,102,120,106.269895149579,33
1940,1997,78,104,120,103.416759838614,42
1940,1998,88,99,121,107.518099942507,33
1940,1999,84,103,116,103.238470572302,32
1940,2000,88,102,122,106.050962696858,34
1940,2006,81,94,115,100.776185035943,34
1940,2007,74,88,109,94.8570656821356,35
1940,2008,80,105,133,107.609974976059,53
1940,2009,83,93,114,99.5239496875964,31
1940,2011,64,80,109,87.0487804396774,45
1940,2013,98,107,133,114.158888792807,35
1940,2014,73,85,108,92.4964807585719,35
1940,2015,78,92,106,95.9559131235147,28
1941,1996,86,106,129,110.87063879787,43
1941,1997,79,97,124,102.10903464422,45
1941,1998,86,106,131,111.065133844502,45
1941,1999,88,99,121,104.680548521623,33
1941,2000,88,103,120,107.567212435772,32
1941,2006,79,93,107,100.928571416764,28
1941,2007,78,99,116,99.8568878919663,38
1941,2008,79,99,121,103.319358990482,42
1941,2009,74,81,106,91.7053571460581,32
1941,2011,64,86,116,92.4821428488404,52
1941,2013,98,107,128,114.893167447783,30
1941,2014,73,93,120,97.8725490165626,47
1941,2015,86,100,120,105.856529189067,34
1942,1997,78,100,126,104.8194969407,48
1942,1998,89,102,126,107.263570441031,37
1942,1999,83,95,110,99.7304525286367,27
1942,2000,88,109,123,111.49331468952,35
1942,2003,84,97,118,101.642858263034,34
1942,2005,87,95,117,101.59783828002,30
1942,2006,78,100,114,102.071589831147,36
1942,2007,71,98,119,100.119070720004,48
1942,2008,83,99,123,105.174733997008,40
1942,2009,82,97,123,100.913753979784,41
1942,2013,96,107,130,114.953968524618,34
1942,2014,81,103,125,106.350216792852,44
1942,2015,89,101,123,106.615384595146,34
1943,1999,86,111,124,110.179233623094,38
1943,2000,88,102,129,110.914140773996,41
1943,2001,87,104,123,108.570639822631,36
1943,2002,89,108,123,109.669946938639,34
1943,2003,75,90,118,97.3951612940105,43
1943,2004,83,104,124,105.102286509326,41
1943,2005,83,88,112,96.9256469743136,29
1943,2006,82,103,123,105.252149575002,41
1943,2007,74,88,109,93.2481409076651,35
1943,2008,81,112,129,111.162702751165,48
1943,2009,75,88,101,90.3053526588296,26
1943,2011,67,81,123,91.1617486316327,56
1943,2013,96,109,130,115.094432010097,34
1943,2014,80,94,115,99.8498511108252,35
1943,2015,81,92,123,101.611322301787,42
1945,1997,92,113,130,115.028750266149,38
1945,1998,104,118,136,122.185740646629,32
1945,1999,93,106,120,108.834635750047,27
1945,2000,91,102,122,109.980625641521,31
1945,2003,98,112,118,111.326086952157,20
1945,2006,91,95,103,97.4545454630312,12
1945,2007,80,95,115,100.999999959871,35
1945,2008,87,112,128,112.946300415093,41
1945,2009,81,111,137,113.157796556987,56
1945,2011,53,95,131,96.6250632051043,78
1945,2013,96,109,123,114.097969034708,27
1945,2014,78,105,130,108.437749421422,52
1945,2015,67,102,144,106.841779521791,77
1950,1994,39,84,123,85.6301495358501,84
1950,1998,61,105,139,104.799729912723,78
1951,1999,86,117,137,116.134427484287,51
1951,2000,95,122,152,124.223234383987,57
1954,1999,88,101,116,102.792949053117,28
1954,2000,86,99,121,105.575220618129,35
1954,2001,85,104,123,108.269361523357,38
1954,2002,85,110,120,110.511695798369,35
1954,2003,76,92,113,97.3225597419827,37
1954,2004,90,96,113,102.990689153966,23
1954,2005,84,100,124,103.276079485792,40
1954,2006,84,92,115,100.679419927249,31
1954,2007,80,96,115,99.469696936314,35
1954,2008,87,104,121,106.490002883745,34
1954,2009,82,96,116,99.0812823117364,34
1955,2002,86,106,133,112.762455489301,47
1955,2003,84,101,124,106.400135895839,40
1956,2002,81,123,155,122.977645121524,74
1956,2003,96,112,128,116.159567555033,32
1957,1999,77,85,116,95.5184408295318,39
1958,2000,88,102,113,102.318181808925,25
1959,1999,97,109,123,110.539828814609,26
1960,1997,93,116,139,118.275371691402,46
1961,2000,88,107,137,115.795849706648,49
1962,2000,88,101,137,113.297621852848,49
1962,2001,93,108,138,114.500000001213,45
1962,2002,95,113,128,115.503816788477,33
1962,2003,95,101,120,105.787234043917,25
1964,2003,87,101,114,104.378219167502,27
1965,2003,86,110,133,113.927497193572,47
1965,2005,87,99,122,106.191082793842,35
1965,2006,85,107,128,107.866904346178,43
1965,2007,78,99,120,104.770968071274,42
1965,2008,87,112,130,114.796205069505,43
1965,2009,82,95,125,104.258176416516,43
1965,2011,74,92,130,99.6872006914936,56
1965,2013,104,118,130,119.148546855281,26
1965,2014,85,106,127,109.574506475513,42
1965,2015,86,101,121,105.998621285001,35
1966,2003,86,104,127,108.680476776059,41
1966,2005,87,100,121,105.259549062563,34
1966,2006,85,102,113,105.922794152863,28
1966,2007,92,106,120,109.166205586797,28
1966,2008,89,109,130,110.981843678362,41
1966,2009,82,102,124,104.683245278662,42
1966,2011,80,100,127,104.81668564683,47
1966,2013,97,118,140,122.010526511408,43
1966,2014,90,103,131,110.352242002932,41
1966,2015,88,102,123,108.567404617892,35
1967,1999,93,108,120,112.70831476687,27
1967,2003,90,103,124,111.141439582905,34
1968,2003,76,103,124,103.223728269751,48
1968,2006,86,105,126,106.454525415461,40
1968,2007,73,98,121,102.083003957252,48
1968,2008,91,112,137,116.44930749591,46
1968,2009,82,95,124,102.301576012278,42
1968,2011,64,87,115,91.7494578539261,51
1968,2013,98,110,134,117.112903225667,36
1968,2014,78,107,120,106.303876189699,42
1968,2015,79,109,137,112.213131493255,58
1969,2003,74,100,137,108.13322673732,63
1970,1999,94,108,122,112.67059221693,28
1970,2000,93,109,135,114.641872748535,42
1970,2003,82,98,115,99.8554214214034,33
1970,2006,90,103,120,106.911687939391,30
1970,2007,90,105,125,109.874835332588,35
1970,2008,93,112,128,114.6694475325,35
1970,2009,84,94,122,102.741006925254,38
1970,2011,82,102,122,104.24232014933,40
1970,2013,99,109,130,115.836157922286,31
1970,2014,88,103,120,106.286351380222,32
1970,2015,88,102,116,105.556349731168,28
1971,2003,81,98,118,102.151831658374,37
1971,2006,67,109,144,110.857548125949,77
1971,2007,67,97,115,98.3614997735783,48
1971,2008,88,101,121,108.445238561109,33
1971,2009,81,93,114,100.063125351789,33
1971,2011,75,93,127,103.728494025731,52
1971,2013,96,106,120,112.037361492714,24
1971,2014,75,85,116,93.8247952179877,41
1971,2015,85,101,125,106.029432983205,40
1974,1997,88,132,167,130.612927551897,79
1974,1998,81,138,179,135.320981043058,98
1974,1999,61,123,161,118.386219715137,100
1976,2003,80,101,113,100.976558181016,33
1976,2006,89,102,119,108.020007852246,30
1976,2008,84,102,112,101.725283245096,28
1976,2009,76,92,113,98.816436949867,37
1977,1999,81,101,123,106.033013581514,42
1977,2000,86,95,113,101.779790907146,27
1977,2006,90,99,115,101.902749006013,25
1977,2007,80,98,121,103.25241289723,41
1977,2008,88,102,126,109.248644544647,38
1977,2009,73,88,111,95.1812736338725,38
1977,2011,75,93,119,97.8000247878494,44
1977,2013,95,109,123,108.366939546569,28
1977,2014,87,102,120,105.867858092057,33
1977,2015,82,95,122,102.900242751305,40
1978,2003,80,101,123,104.960288512618,43
1979,2003,110,118,118,117.999999999844,8
1980,2003,76,98,118,100.340911076942,42
1980,2004,90,110,128,111.064391693978,38
1981,2006,72,116,150,115.991859056033,78
1981,2008,62,104,146,103.155707982373,84
1981,2009,88,103,124,107.371711770491,36
1981,2014,80,116,153,119.442985575522,73
1981,2015,84,96,116,100.75333320802,32
1982,2007,72,109,147,111.730034179502,75
1982,2008,98,106,126,110.912477733177,28
1982,2009,58,98,127,99.3937625932603,69
1982,2011,73,87,102,88.5394535511788,29
1982,2013,98,107,123,110.635236528151,25
1982,2014,85,93,106,100.886081993928,21
1982,2015,82,102,115,102.875637089355,33
1983,2006,81,102,130,106.036531981426,49
1983,2007,78,109,137,112.124760542456,59
1983,2008,91,106,137,115.963660144466,46
1983,2009,84,101,130,107.523456228898,46
1984,2006,85,99,114,104.545193782742,29
1984,2007,88,112,122,110.717560493759,34
1984,2008,95,111,122,115.778862205876,27
1984,2009,82,93,114,98.4840673224486,32
1984,2011,79,94,106,95.1679008196078,27
1984,2013,91,116,145,118.625085635649,54
1984,2014,116,123,130,125.89203455127,14
1984,2015,96,101,108,104.327985448578,12
1985,2003,32,81,131,84.3746820430323,99
1985,2009,75,89,110,94.18456043612,35
1987,2005,88,102,125,109.616648937038,37
1987,2006,89,102,120,107.932989685978,31
1987,2007,81,100,122,106.380952379388,41
1987,2008,92,106,132,113.683115440073,40
1987,2009,85,100,121,104.213836481486,36
1987,2013,101,107,127,115.393331041039,26
1987,2014,85,100,120,105.81150372849,35
1989,2006,78,92,116,101.061647536051,38
1989,2007,73,104,123,102.9599999935,50
1989,2008,85,101,128,107.828113462905,43
1989,2009,80,92,122,100.623523169629,42
1989,2011,81,95,127,102.764994869625,46
1989,2013,97,109,123,112.384036914695,26
1989,2014,78,94,113,97.8474164677805,35
1989,2015,85,101,125,104.407572922129,40
1990,2006,95,99,106,103.081714069886,11
1990,2008,87,104,123,109.719673859041,36
1990,2009,79,93,112,100.052918386977,33
1991,2005,79,93,114,98.0714285323039,35
1991,2006,88,102,120,105.956548238459,32
1991,2007,88,99,120,106.667757683341,32
1991,2008,78,104,124,107.072086892796,46
1991,2009,81,102,124,103.126334214863,43
1991,2011,72,93,115,98.168130233691,43
1991,2013,100,112,130,117.175742227987,30
1991,2014,78,103,127,104.440063363457,49
1991,2015,88,109,123,108.996113721247,35
1992,2008,92,115,136,120.025757423383,44
1992,2009,88,116,158,122.886224131344,70
1992,2011,81,94,155,111.144550603572,74
1992,2013,102,116,145,121.632494929219,43
1992,2014,86,106,131,113.132022336625,45
1992,2015,86,109,128,112.466614489897,42
1993,2006,78,99,120,104.16582580761,42
1993,2008,96,111,138,116.432098731744,42
1993,2009,81,95,123,105.171550944448,42
1993,2011,74,93,121,97.748763577477,47
1993,2013,81,111,133,111.49547015025,52
1993,2014,73,94,123,99.5102038532481,50
1993,2015,86,101,123,104.117357282858,37
1994,2006,83,102,118,104.877983280454,35
1994,2008,84,109,137,113.64650264813,53
1994,2009,83,92,109,97.9309779931138,26
1997,2006,85,99,137,110.2360241199,52
1997,2007,80,105,147,112.148175138252,67
1997,2008,88,109,142,115.892558623728,54
1997,2009,83,93,136,106.387694501057,53
1998,2007,84,102,131,104.602167825662,47
1998,2008,95,106,132,112.391954615417,37
1998,2009,81,95,116,101.404401471178,35
1998,2011,73,95,117,97.0310615203596,44
1998,2013,97,106,123,109.23541898774,26
1998,2014,74,85,106,94.093135693104,32
1998,2015,82,98,119,102.787745068219,37
1999,2008,86,99,125,107.899347619483,39
1999,2009,78,95,117,98.3703130770134,39
1999,2011,75,99,134,106.303325563815,59
1999,2013,86,98,125,104.565535013273,39
1999,2014,74,104,125,101.078705242702,51
1999,2015,82,106,130,108.852821382349,48
2000,1992,82,105,121,107.809379840305,39
2000,1994,101,108,137,116.473091655602,36
2000,1995,93,111,131,115.55114644574,38
2000,1996,98,118,127,117.036481935183,29
2000,1997,97,104,139,114.251203339181,42
2000,1998,100,129,147,129.666471215959,47
2000,1999,99,123,147,124.282513886842,48
2000,2000,78,120,156,121.259068514219,78
2000,2001,99,119,139,120.223584858382,40
2000,2002,83,106,136,115.6669749602,53
2000,2003,79,109,147,115.017276651103,68
2000,2004,98,120,151,127.274304725534,53
2000,2005,87,124,153,123.862833365183,66
2000,2006,90,104,130,109.187813087568,40
2000,2007,74,93,116,98.6573255872171,42
2000,2008,85,113,139,115.699929592463,54
2001,1986,92,114,142,119.442028942207,50
2001,1987,94,115,141,120.47272280293,47
2001,1988,90,118,137,116.979404999635,47
2001,1989,73,94,124,99.0189873057098,51
2001,1990,77,102,130,106.78195486716,53
2001,1991,101,120,151,126.350218617567,50
2001,1992,87,113,140,117.187916904421,53
2001,1993,86,108,135,114.485578509131,49
2001,1994,92,113,137,119.038296797691,45
2001,1995,89,101,131,110.607000322854,42
2001,1996,98,113,143,121.619496529194,45
2001,1997,81,113,141,114.00498316818,60
2001,1998,91,110,139,114.737732777407,48
2001,1999,85,110,136,115.448545312441,51
2001,2000,88,109,142,118.047021597453,54
2001,2001,94,121,151,123.684241250439,57
2001,2002,95,129,156,128.2541832618,61
2001,2003,85,121,144,121.378001628237,59
2001,2004,104,127,153,130.428295942515,49
2001,2005,88,119,145,119.127286022063,57
2001,2006,84,108,147,116.348762860042,63
2001,2007,82,118,159,120.941647091144,77
2001,2008,92,137,156,135.709768957297,64
2001,2009,85,116,151,121.181818181821,66
2001,2011,82,131,156,123.366537618991,74
2001,2013,99,130,165,133.63701516915,66
2001,2014,82,111,135,113.73214285319,53
2001,2015,88,116,144,118.250843660584,56
2003,1994,102,120,144,124.278371562704,42
2003,1995,90,115,136,116.063616545847,46
2003,1996,101,121,148,127.325837613854,47
2003,1997,93,128,155,128.781253818666,62
2003,1998,111,134,149,135.429545393699,38
2003,2001,95,121,150,128.036943685647,55
2003,2007,80,130,158,127.235788401622,78
2003,2008,92,134,154,133.128633962087,62
2003,2009,81,131,149,127.416790134476,68
2003,2011,68,102,144,109.156496623054,76
2003,2012,92,132,157,131.396901280968,65
2003,2013,93,128,156,131.106669522882,63
2003,2014,78,130,151,126.191388317463,73
2003,2015,90,134,163,130.895698065163,73
2004,1994,102,120,144,122.899830987802,42
2004,1995,88,111,132,116.860504543387,44
2004,1996,99,124,144,125.689523365226,45
2004,1997,99,130,148,131.444370461494,49
2004,1998,107,128,150,132.798956288819,43
2004,2000,97,122,152,126.64899844573,55
2004,2001,95,116,146,123.871743790276,51
2004,2002,95,129,156,128.743371692959,61
2004,2003,85,119,147,117.651856751098,62
2004,2004,104,124,144,127.845875101455,40
2004,2005,90,118,143,121.737832821903,53
2004,2006,89,109,141,116.178530183097,52
2004,2007,82,110,138,113.361667572478,56
2004,2008,85,126,151,124.819826858967,66
2004,2009,86,123,144,124.717596661427,58
2004,2011,94,137,156,137.624252697455,62
2004,2012,96,131,156,132.423096622395,60
2004,2013,106,130,150,132.290904022357,44
2004,2014,94,120,142,120.262713794603,48
2004,2015,91,123,149,123.507618943479,58
2006,1994,102,121,144,124.006221183006,42
2006,1995,95,119,136,119.337481810444,41
2006,1996,96,125,143,124.238742153903,47
2006,1997,85,120,154,124.336736806353,69
2006,1998,105,136,158,134.774228814969,53
2006,2000,91,122,151,125.669090518251,60
2006,2001,95,113,146,121.18750303457,51
2006,2002,81,117,143,119.546443691609,62
2006,2003,81,119,142,118.627930839315,61
2006,2004,90,124,154,126.047652297699,64
2006,2005,90,119,153,121.502808989992,63
2006,2006,90,110,152,117.405381802229,62
2006,2007,74,102,147,110.920881661509,73
2006,2008,85,115,152,122.478364276373,67
2006,2009,81,111,153,115.376650262189,72
2006,2012,89,123,151,124.850864964575,62
2006,2013,96,113,150,120.300632904148,54
2006,2014,74,108,142,110.745540587093,68
2006,2015,85,109,143,115.147267762898,58
2007,1990,78,104,113,101.97339588109,35
2007,1991,99,113,141,123.047618991649,42
2007,1992,85,105,128,108.6960817215,43
2007,1993,88,102,123,105.522058826923,35
2007,1994,92,106,127,114.493589743141,35
2007,1995,87,100,120,105.728476795581,33
2007,1996,96,110,127,115.252684885953,31
2007,1997,85,112,121,110.195945944235,36
2007,1998,96,115,134,117.492187498305,38
2007,1999,93,108,121,112.118518464801,28
2007,2000,88,108,134,115.102346183149,46
2007,2001,93,107,137,114.839068269381,44
2007,2002,87,113,135,116.279661012605,48
2007,2003,85,106,129,111.591999997911,44
2007,2004,86,120,136,119.558243702558,50
2007,2005,88,108,131,114.650655028711,43
2007,2006,84,102,120,103.478482169417,36
2007,2007,80,110,138,111.629268274492,58
2007,2008,91,115,134,117.116881176376,43
2007,2009,84,101,127,106.925696582576,43
2007,2015,74,102,130,105.434447270673,56
2008,1990,81,94,113,100.55410562333,32
2008,1991,105,113,134,119.376429984198,29
2008,1992,86,102,120,106.519152511167,34
2008,1993,92,108,129,113.084959429774,37
2008,1994,97,111,125,112.832985864981,28
2008,1995,80,111,133,111.480688848556,53
2008,1996,105,113,127,116.444649677878,22
2008,1997,88,112,130,112.378675017059,42
2008,1998,88,119,136,118.860491685198,48
2008,1999,93,110,128,115.18024538146,35
2008,2000,89,111,128,114.641209254454,39
2008,2001,93,107,127,114.292682926627,34
2008,2002,95,117,135,117.374045886781,40
2008,2003,85,106,130,111.589830502486,45
2008,2004,97,114,137,120.673817361612,40
2008,2005,95,106,127,113.152734966463,32
2008,2006,92,107,120,110.380042922097,28
2008,2007,80,100,122,107.24192788888,42
2008,2008,96,111,137,118.393549998273,41
2008,2009,88,101,128,108.771386879072,40
2008,2011,74,105,132,106.283724215789,58
2008,2013,98,118,130,117.770004609975,32
2008,2014,88,103,120,107.63127755978,32
2008,2015,85,112,137,114.200249759651,52
2010,1988,90,125,144,123.081198053499,54
2010,1989,78,111,130,111.67946285082,52
2010,1990,88,119,144,117.590665880874,56
2010,1991,113,138,149,138.499234012435,36
2010,1992,97,120,146,124.342069416364,49
2010,1993,92,129,150,128.498201430936,58
2010,1994,102,123,144,122.521206312722,42
2010,1995,88,111,136,114.686102662709,48
2010,1996,101,122,149,129.159368477605,48
2010,1997,106,135,157,136.986499044117,51
2010,1998,123,144,157,144.957805761917,34
2010,1999,108,123,155,131.338767585321,47
2010,2000,88,129,156,129.851867306924,68
2010,2001,92,120,158,127.811436210083,66
2010,2002,105,135,155,134.317233539439,50
2010,2003,85,124,146,123.48655904995,61
2010,2004,108,136,155,136.288814691152,47
2010,2005,101,138,162,137.728571432162,61
2010,2006,93,141,162,135.94342290701,69
2010,2007,113,148,169,148.981416791432,56
2010,2008,115,137,156,138.054607509709,41
2010,2009,92,136,155,133.206673804051,63
2010,2011,110,134,163,139.59043362009,53
2010,2013,106,134,155,137.690051974495,49
2010,2014,103,121,150,128.460498231707,47
2010,2015,94,139,173,138.682229658852,79
2011,2000,95,128,156,133.084733708185,61
2011,2002,113,135,155,139.906714676085,42
2011,2003,105,125,141,128.20042844376,36
2011,2004,114,136,153,135.906018248306,39
2011,2005,92,124,156,128.421216848674,64
2011,2006,92,120,149,126.484657941046,57
2011,2007,98,144,166,138.786392876835,68
2011,2008,105,129,152,133.43860056741,47
2012,1997,80,95,118,100.266055384381,38
2012,1998,80,95,118,100.266055384381,38
2012,1999,80,95,118,100.266055384381,38
2012,2000,80,95,118,100.266055384381,38
2012,2001,91,100,118,106.406396948612,27
2012,2002,82,95,124,102.069201325369,42
2012,2003,82,96,119,98.8855696573771,37
2013,1990,80,94,130,105.105029043399,50
2013,1991,102,120,141,125.517028064821,39
2013,1992,89,115,143,120.754366530137,54
2013,1993,86,116,141,118.031942511838,55
2013,1994,96,110,131,116.101541715624,35
2013,1995,91,103,145,114.6856672909,54
2013,1996,95,113,141,121.282669362803,46
2013,1997,105,136,162,138.663343544634,57
2013,1998,106,135,160,140.388930263156,54
2013,1999,93,126,153,127.322425720427,60
2013,2000,92,123,151,128.445630590554,59
2013,2001,86,116,146,119.19631901675,60
2013,2002,85,117,153,120.68605431556,68
2013,2003,81,110,144,114.179556824095,63
2013,2004,89,120,153,125.053007233595,64
2013,2005,88,126,157,126.346315988444,69
2013,2006,85,116,149,120.752418731696,64
2013,2007,80,124,157,123.588772991675,77
2013,2008,86,122,152,125.473187826552,66
2013,2009,84,101,139,111.090245876818,55
2013,2011,84,123,158,125.413104184028,74
2013,2013,101,117,149,125.963639125019,48
2013,2014,86,112,140,115.50340135957,54
2013,2015,80,110,144,114.406710351586,64
2014,1988,82,111,138,113.04285577593,56
2014,1989,87,112,139,113.623300416269,52
2014,1990,88,118,144,121.16822969938,56
2014,1991,108,138,155,136.196510566852,47
2014,1992,86,120,151,123.032925133308,65
2014,1993,92,127,150,128.84751332261,58
2014,1994,102,127,148,128.551521691598,46
2014,1995,95,115,143,122.101136888913,48
2014,1996,101,130,149,130.630130552269,48
2014,1997,98,133,158,129.401084134526,60
2014,1998,100,127,163,134.117477466558,63
2014,1999,92,124,149,126.427773930932,57
2014,2000,103,129,156,129.940621090851,53
2014,2001,91,120,157,125.365129175205,66
2014,2002,80,128,157,127.226286026253,77
2014,2003,88,119,151,121.19891927785,63
2014,2004,89,118,151,123.273261462971,62
2014,2005,88,123,152,125.05143295536,64
2014,2006,89,109,152,119.934531860628,63
2014,2008,94,129,156,130.534703266587,62
2014,2009,90,130,159,128.828550778289,69
2014,2011,81,125,158,124.854049566797,77
2014,2012,97,134,173,135.969331624214,76
2014,2013,100,130,163,134.943260494556,63
2014,2014,82,113,153,119.534302608137,71
